Winamax Poker - Tournament "Kill The Fish" buyIn: 9€ + 1€ level: 7 - HandId: #713500187917549576-31-1471370402 - Holdem no limit (30/200/400) - 2016/08/16 18:00:02 UTC
Table: 'Kill The Fish(166124708)#007' 8-max (real money) Seat #3 is the button
Seat 1: Lucho51_13 (44880)
Seat 2: almaju (13013)
Seat 3: 427alligator (10785)
Seat 4: manggy94 (10000)
Seat 5: Ayouki (6745)
Seat 6: allinJoe2014 (3815)
Seat 7: maksuamet (10182)
Seat 8: Une_chaise (10580)
*** ANTE/BLINDS ***
Ayouki posts ante 30
Lucho51_13 posts ante 30
almaju posts ante 30
427alligator posts ante 30
allinJoe2014 posts ante 30
maksuamet posts ante 30
Une_chaise posts ante 30
Ayouki posts big blind 400
*** PRE-FLOP *** 
allinJoe2014 folds
maksuamet folds
Une_chaise folds
Lucho51_13 calls 400
almaju folds
427alligator folds
Ayouki raises 400 to 800
Lucho51_13 calls 400
*** FLOP *** [6s Qd Kh]
Ayouki checks
Lucho51_13 bets 400
Ayouki folds
Lucho51_13 collected 2210 from pot
*** SUMMARY ***
Total pot 2210 | No rake
Board: [6s Qd Kh]
Seat 1: Lucho51_13 won 2210


Winamax Poker - Tournament "Kill The Fish" buyIn: 9€ + 1€ level: 8 - HandId: #713500187917549576-33-1471370556 - Holdem no limit (40/250/500) - 2016/08/16 18:02:36 UTC
Table: 'Kill The Fish(166124708)#007' 8-max (real money) Seat #5 is the button
Seat 1: Lucho51_13 (45430)
Seat 2: almaju (12553)
Seat 3: 427alligator (10725)
Seat 4: manggy94 (10000)
Seat 5: Ayouki (7295)
Seat 6: allinJoe2014 (3355)
Seat 7: maksuamet (10122)
Seat 8: Une_chaise (10520)
*** ANTE/BLINDS ***
allinJoe2014 posts ante 40
maksuamet posts ante 40
Lucho51_13 posts ante 40
almaju posts ante 40
427alligator posts ante 40
manggy94 posts ante 40
Ayouki posts ante 40
Une_chaise posts ante 40
allinJoe2014 posts small blind 250
maksuamet posts big blind 500
Dealt to manggy94 [9s 5s]
*** PRE-FLOP *** 
Une_chaise folds
Lucho51_13 calls 500
almaju folds
427alligator raises 500 to 1000
manggy94 folds
Ayouki folds
allinJoe2014 folds
maksuamet folds
Lucho51_13 calls 500
*** FLOP *** [8d 2c Jh]
Lucho51_13 checks
427alligator bets 1535
Lucho51_13 folds
427alligator collected 4605 from pot
*** SUMMARY ***
Total pot 4605 | No rake
Board: [8d 2c Jh]
Seat 3: 427alligator won 4605


Winamax Poker - Tournament "Kill The Fish" buyIn: 9€ + 1€ level: 8 - HandId: #713500187917549576-34-1471370604 - Holdem no limit (40/250/500) - 2016/08/16 18:03:24 UTC
Table: 'Kill The Fish(166124708)#007' 8-max (real money) Seat #6 is the button
Seat 1: Lucho51_13 (44390)
Seat 2: almaju (12513)
Seat 3: 427alligator (12755)
Seat 4: manggy94 (9960)
Seat 5: Ayouki (7255)
Seat 6: allinJoe2014 (3065)
Seat 7: maksuamet (9582)
Seat 8: Une_chaise (10480)
*** ANTE/BLINDS ***
maksuamet posts ante 40
Une_chaise posts ante 40
Lucho51_13 posts ante 40
almaju posts ante 40
427alligator posts ante 40
manggy94 posts ante 40
Ayouki posts ante 40
allinJoe2014 posts ante 40
maksuamet posts small blind 250
Une_chaise posts big blind 500
Dealt to manggy94 [5c Kd]
*** PRE-FLOP *** 
Lucho51_13 folds
almaju raises 1250 to 1750
427alligator folds
manggy94 folds
Ayouki folds
allinJoe2014 folds
maksuamet folds
Une_chaise folds
almaju collected 2820 from pot
*** SUMMARY ***
Total pot 2820 | No rake
Seat 2: almaju won 2820


Winamax Poker - Tournament "Kill The Fish" buyIn: 9€ + 1€ level: 8 - HandId: #713500187917549576-35-1471370647 - Holdem no limit (40/250/500) - 2016/08/16 18:04:07 UTC
Table: 'Kill The Fish(166124708)#007' 8-max (real money) Seat #7 is the button
Seat 1: Lucho51_13 (44350)
Seat 2: almaju (13543)
Seat 3: 427alligator (12715)
Seat 4: manggy94 (9920)
Seat 5: Ayouki (7215)
Seat 6: allinJoe2014 (3025)
Seat 7: maksuamet (9292)
Seat 8: Une_chaise (9940)
*** ANTE/BLINDS ***
Une_chaise posts ante 40
Lucho51_13 posts ante 40
almaju posts ante 40
427alligator posts ante 40
manggy94 posts ante 40
Ayouki posts ante 40
allinJoe2014 posts ante 40
maksuamet posts ante 40
Une_chaise posts small blind 250
Lucho51_13 posts big blind 500
Dealt to manggy94 [3c 3h]
*** PRE-FLOP *** 
almaju calls 500
427alligator calls 500
manggy94 raises 500 to 1000
Ayouki folds
allinJoe2014 raises 1985 to 2985 and is all-in
maksuamet folds
Une_chaise folds
Lucho51_13 folds
almaju calls 2485
427alligator folds
manggy94 folds
*** FLOP *** [7h Tc 3s]
*** TURN *** [7h Tc 3s][Jd]
*** RIVER *** [7h Tc 3s Jd][6d]
*** SHOW DOWN ***
allinJoe2014 shows [Qd Ah] (High card : Ace)
almaju shows [Ts Kd] (One pair : Tens)
almaju collected 8540 from pot
*** SUMMARY ***
Total pot 8540 | No rake
Board: [7h Tc 3s Jd 6d]
Seat 2: almaju showed [Ts Kd] and won 8540 with One pair : Tens
Seat 6: allinJoe2014 showed [Qd Ah] and lost with High card : Ace


Winamax Poker - Tournament "Kill The Fish" buyIn: 9€ + 1€ level: 8 - HandId: #713500187917549576-36-1471370730 - Holdem no limit (40/250/500) - 2016/08/16 18:05:30 UTC
Table: 'Kill The Fish(166124708)#007' 8-max (real money) Seat #8 is the button
Seat 1: Lucho51_13 (43810)
Seat 2: almaju (19058)
Seat 3: 427alligator (12175)
Seat 4: manggy94 (8880)
Seat 5: Ayouki (7175)
Seat 7: maksuamet (9252)
Seat 8: Une_chaise (9650)
*** ANTE/BLINDS ***
Lucho51_13 posts ante 40
almaju posts ante 40
427alligator posts ante 40
manggy94 posts ante 40
Ayouki posts ante 40
maksuamet posts ante 40
Une_chaise posts ante 40
Lucho51_13 posts small blind 250
almaju posts big blind 500
Dealt to manggy94 [9s Qd]
*** PRE-FLOP *** 
427alligator folds
manggy94 folds
Ayouki folds
maksuamet folds
Une_chaise folds
Lucho51_13 calls 250
almaju checks
*** FLOP *** [Jd 5d Jc]
Lucho51_13 checks
almaju checks
*** TURN *** [Jd 5d Jc][3d]
Lucho51_13 bets 500
almaju folds
Lucho51_13 collected 1780 from pot
*** SUMMARY ***
Total pot 1780 | No rake
Board: [Jd 5d Jc 3d]
Seat 1: Lucho51_13 (small blind) won 1780


Winamax Poker - Tournament "Kill The Fish" buyIn: 9€ + 1€ level: 8 - HandId: #713500187917549576-37-1471370766 - Holdem no limit (40/250/500) - 2016/08/16 18:06:06 UTC
Table: 'Kill The Fish(166124708)#007' 8-max (real money) Seat #1 is the button
Seat 1: Lucho51_13 (44550)
Seat 2: almaju (18518)
Seat 3: 427alligator (12135)
Seat 4: manggy94 (8840)
Seat 5: Ayouki (7135)
Seat 6: charbon11 (10000)
Seat 7: maksuamet (9212)
Seat 8: Une_chaise (9610)
*** ANTE/BLINDS ***
almaju posts ante 40
427alligator posts ante 40
Lucho51_13 posts ante 40
manggy94 posts ante 40
Ayouki posts ante 40
charbon11 posts ante 40
maksuamet posts ante 40
Une_chaise posts ante 40
almaju posts small blind 250
427alligator posts big blind 500
Dealt to manggy94 [2c Ks]
*** PRE-FLOP *** 
manggy94 folds
Ayouki folds
charbon11 calls 500
maksuamet calls 500
Une_chaise folds
Lucho51_13 calls 500
almaju calls 250
427alligator checks
*** FLOP *** [Kh 6h 6s]
almaju checks
427alligator bets 1410
charbon11 folds
maksuamet folds
Lucho51_13 folds
almaju calls 1410
*** TURN *** [Kh 6h 6s][2h]
almaju checks
427alligator checks
*** RIVER *** [Kh 6h 6s 2h][7s]
almaju bets 3250
427alligator folds
almaju collected 8890 from pot
*** SUMMARY ***
Total pot 8890 | No rake
Board: [Kh 6h 6s 2h 7s]
Seat 2: almaju (small blind) won 8890


Winamax Poker - Tournament "Kill The Fish" buyIn: 9€ + 1€ level: 8 - HandId: #713500187917549576-38-1471370864 - Holdem no limit (40/250/500) - 2016/08/16 18:07:44 UTC
Table: 'Kill The Fish(166124708)#007' 8-max (real money) Seat #2 is the button
Seat 1: Lucho51_13 (44010)
Seat 2: almaju (22208)
Seat 3: 427alligator (10185)
Seat 4: manggy94 (8800)
Seat 5: Ayouki (7095)
Seat 6: charbon11 (9460)
Seat 7: maksuamet (8672)
Seat 8: Une_chaise (9570)
*** ANTE/BLINDS ***
427alligator posts ante 40
manggy94 posts ante 40
Lucho51_13 posts ante 40
almaju posts ante 40
Ayouki posts ante 40
charbon11 posts ante 40
maksuamet posts ante 40
Une_chaise posts ante 40
427alligator posts small blind 250
manggy94 posts big blind 500
Dealt to manggy94 [9c 2c]
*** PRE-FLOP *** 
Ayouki folds
charbon11 calls 500
maksuamet folds
Une_chaise raises 1000 to 1500
Lucho51_13 folds
almaju folds
427alligator folds
manggy94 folds
charbon11 calls 1000
*** FLOP *** [5c 4c 3c]
charbon11 checks
Une_chaise checks
*** TURN *** [5c 4c 3c][9s]
charbon11 bets 500
Une_chaise calls 500
*** RIVER *** [5c 4c 3c 9s][6d]
charbon11 checks
Une_chaise checks
*** SHOW DOWN ***
Une_chaise shows [As Qc] (High card : Ace)
charbon11 shows [3d 3s] (Trips of 3)
charbon11 collected 5070 from pot
*** SUMMARY ***
Total pot 5070 | No rake
Board: [5c 4c 3c 9s 6d]
Seat 6: charbon11 showed [3d 3s] and won 5070 with Trips of 3
Seat 8: Une_chaise showed [As Qc] and lost with High card : Ace


Winamax Poker - Tournament "Kill The Fish" buyIn: 9€ + 1€ level: 9 - HandId: #713500187917549576-39-1471370960 - Holdem no limit (60/300/600) - 2016/08/16 18:09:20 UTC
Table: 'Kill The Fish(166124708)#007' 8-max (real money) Seat #3 is the button
Seat 1: Lucho51_13 (43970)
Seat 2: almaju (22168)
Seat 3: 427alligator (9895)
Seat 4: manggy94 (8260)
Seat 5: Ayouki (7055)
Seat 6: charbon11 (12490)
Seat 7: maksuamet (8632)
Seat 8: Une_chaise (7530)
*** ANTE/BLINDS ***
manggy94 posts ante 60
Ayouki posts ante 60
Lucho51_13 posts ante 60
almaju posts ante 60
427alligator posts ante 60
charbon11 posts ante 60
maksuamet posts ante 60
Une_chaise posts ante 60
manggy94 posts small blind 300
Ayouki posts big blind 600
Dealt to manggy94 [2h Ah]
*** PRE-FLOP *** 
charbon11 folds
maksuamet folds
Une_chaise folds
Lucho51_13 folds
almaju calls 600
427alligator calls 600
manggy94 raises 600 to 1200
Ayouki calls 600
almaju calls 600
427alligator calls 600
*** FLOP *** [9d 2d 5d]
manggy94 checks
Ayouki checks
almaju bets 1200
427alligator folds
manggy94 folds
Ayouki folds
almaju collected 6480 from pot
*** SUMMARY ***
Total pot 6480 | No rake
Board: [9d 2d 5d]
Seat 2: almaju won 6480


Winamax Poker - Tournament "Kill The Fish" buyIn: 9€ + 1€ level: 9 - HandId: #713500187917549576-40-1471371061 - Holdem no limit (60/300/600) - 2016/08/16 18:11:01 UTC
Table: 'Kill The Fish(166124708)#007' 8-max (real money) Seat #4 is the button
Seat 1: Lucho51_13 (43910)
Seat 2: almaju (26188)
Seat 3: 427alligator (8635)
Seat 4: manggy94 (7000)
Seat 5: Ayouki (5795)
Seat 6: charbon11 (12430)
Seat 7: maksuamet (8572)
Seat 8: Une_chaise (7470)
*** ANTE/BLINDS ***
Ayouki posts ante 60
charbon11 posts ante 60
Lucho51_13 posts ante 60
almaju posts ante 60
427alligator posts ante 60
manggy94 posts ante 60
maksuamet posts ante 60
Une_chaise posts ante 60
Ayouki posts small blind 300
charbon11 posts big blind 600
Dealt to manggy94 [Ts Qc]
*** PRE-FLOP *** 
maksuamet folds
Une_chaise folds
Lucho51_13 calls 600
almaju folds
427alligator folds
manggy94 calls 600
Ayouki folds
charbon11 checks
*** FLOP *** [6d Ad Td]
charbon11 checks
Lucho51_13 checks
manggy94 checks
*** TURN *** [6d Ad Td][4d]
charbon11 checks
Lucho51_13 checks
manggy94 checks
*** RIVER *** [6d Ad Td 4d][9s]
charbon11 checks
Lucho51_13 checks
manggy94 checks
*** SHOW DOWN ***
Lucho51_13 shows [Jc Qh] (High card : Ace)
charbon11 shows [5h 2h] (High card : Ace)
manggy94 shows [Ts Qc] (One pair : Tens)
manggy94 collected 2580 from pot
*** SUMMARY ***
Total pot 2580 | No rake
Board: [6d Ad Td 4d 9s]
Seat 1: Lucho51_13 showed [Jc Qh] and lost with High card : Ace
Seat 4: manggy94 (button) showed [Ts Qc] and won 2580 with One pair : Tens
Seat 6: charbon11 (big blind) showed [5h 2h] and lost with High card : Ace


Winamax Poker - Tournament "Kill The Fish" buyIn: 9€ + 1€ level: 9 - HandId: #713500187917549576-41-1471371156 - Holdem no limit (60/300/600) - 2016/08/16 18:12:36 UTC
Table: 'Kill The Fish(166124708)#007' 8-max (real money) Seat #5 is the button
Seat 1: Lucho51_13 (43250)
Seat 2: almaju (26128)
Seat 3: 427alligator (8575)
Seat 4: manggy94 (8920)
Seat 5: Ayouki (5435)
Seat 6: charbon11 (11770)
Seat 7: maksuamet (8512)
Seat 8: Une_chaise (7410)
*** ANTE/BLINDS ***
charbon11 posts ante 60
maksuamet posts ante 60
Lucho51_13 posts ante 60
almaju posts ante 60
427alligator posts ante 60
manggy94 posts ante 60
Ayouki posts ante 60
Une_chaise posts ante 60
charbon11 posts small blind 300
maksuamet posts big blind 600
Dealt to manggy94 [Qs 3d]
*** PRE-FLOP *** 
Une_chaise folds
Lucho51_13 calls 600
almaju folds
427alligator folds
manggy94 folds
Ayouki folds
charbon11 folds
maksuamet checks
*** FLOP *** [6d Ac 3h]
maksuamet checks
Lucho51_13 checks
*** TURN *** [6d Ac 3h][9c]
maksuamet checks
Lucho51_13 bets 600
maksuamet folds
Lucho51_13 collected 2580 from pot
*** SUMMARY ***
Total pot 2580 | No rake
Board: [6d Ac 3h 9c]
Seat 1: Lucho51_13 won 2580


Winamax Poker - Tournament "Kill The Fish" buyIn: 9€ + 1€ level: 9 - HandId: #713500187917549576-42-1471371235 - Holdem no limit (60/300/600) - 2016/08/16 18:13:55 UTC
Table: 'Kill The Fish(166124708)#007' 8-max (real money) Seat #6 is the button
Seat 1: Lucho51_13 (44570)
Seat 2: almaju (26068)
Seat 3: 427alligator (8515)
Seat 4: manggy94 (8860)
Seat 5: Ayouki (5375)
Seat 6: charbon11 (11410)
Seat 7: maksuamet (7852)
Seat 8: Une_chaise (7350)
*** ANTE/BLINDS ***
maksuamet posts ante 60
Une_chaise posts ante 60
Lucho51_13 posts ante 60
almaju posts ante 60
427alligator posts ante 60
manggy94 posts ante 60
Ayouki posts ante 60
charbon11 posts ante 60
maksuamet posts small blind 300
Une_chaise posts big blind 600
Dealt to manggy94 [8s Qs]
*** PRE-FLOP *** 
Lucho51_13 calls 600
almaju folds
427alligator folds
manggy94 calls 600
Ayouki folds
charbon11 folds
maksuamet folds
Une_chaise checks
*** FLOP *** [7s 4d 9c]
Une_chaise checks
Lucho51_13 checks
manggy94 bets 600
Une_chaise folds
Lucho51_13 calls 600
*** TURN *** [7s 4d 9c][2h]
Lucho51_13 checks
manggy94 bets 1890
Lucho51_13 folds
manggy94 collected 5670 from pot
*** SUMMARY ***
Total pot 5670 | No rake
Board: [7s 4d 9c 2h]
Seat 4: manggy94 won 5670


Winamax Poker - Tournament "Kill The Fish" buyIn: 9€ + 1€ level: 10 - HandId: #713500187917549576-43-1471371284 - Holdem no limit (75/400/800) - 2016/08/16 18:14:44 UTC
Table: 'Kill The Fish(166124708)#007' 8-max (real money) Seat #7 is the button
Seat 1: Lucho51_13 (43310)
Seat 2: almaju (26008)
Seat 3: 427alligator (8455)
Seat 4: manggy94 (11380)
Seat 5: Ayouki (5315)
Seat 6: charbon11 (11350)
Seat 7: maksuamet (7492)
Seat 8: Une_chaise (6690)
*** ANTE/BLINDS ***
Une_chaise posts ante 75
Lucho51_13 posts ante 75
almaju posts ante 75
427alligator posts ante 75
manggy94 posts ante 75
Ayouki posts ante 75
charbon11 posts ante 75
maksuamet posts ante 75
Une_chaise posts small blind 400
Lucho51_13 posts big blind 800
Dealt to manggy94 [5c 3s]
*** PRE-FLOP *** 
almaju folds
427alligator folds
manggy94 folds
Ayouki folds
charbon11 folds
maksuamet folds
Une_chaise folds
Lucho51_13 collected 1800 from pot
*** SUMMARY ***
Total pot 1800 | No rake
Seat 1: Lucho51_13 (big blind) won 1800


Winamax Poker - Tournament "Kill The Fish" buyIn: 9€ + 1€ level: 10 - HandId: #713500187917549576-44-1471371300 - Holdem no limit (75/400/800) - 2016/08/16 18:15:00 UTC
Table: 'Kill The Fish(166124708)#007' 8-max (real money) Seat #8 is the button
Seat 1: Lucho51_13 (44235)
Seat 2: almaju (25933)
Seat 3: 427alligator (8380)
Seat 4: manggy94 (11305)
Seat 5: Ayouki (5240)
Seat 6: charbon11 (11275)
Seat 7: maksuamet (7417)
Seat 8: Une_chaise (6215)
*** ANTE/BLINDS ***
Lucho51_13 posts ante 75
almaju posts ante 75
427alligator posts ante 75
manggy94 posts ante 75
Ayouki posts ante 75
charbon11 posts ante 75
maksuamet posts ante 75
Une_chaise posts ante 75
Lucho51_13 posts small blind 400
almaju posts big blind 800
Dealt to manggy94 [Ks Ac]
*** PRE-FLOP *** 
427alligator folds
manggy94 raises 2400 to 3200
Ayouki folds
charbon11 folds
maksuamet folds
Une_chaise folds
Lucho51_13 folds
almaju folds
manggy94 collected 5000 from pot
*** SUMMARY ***
Total pot 5000 | No rake
Seat 4: manggy94 won 5000


Winamax Poker - Tournament "Kill The Fish" buyIn: 9€ + 1€ level: 10 - HandId: #713500187917549576-45-1471371350 - Holdem no limit (75/400/800) - 2016/08/16 18:15:50 UTC
Table: 'Kill The Fish(166124708)#007' 8-max (real money) Seat #1 is the button
Seat 1: Lucho51_13 (43760)
Seat 2: almaju (25058)
Seat 3: 427alligator (8305)
Seat 4: manggy94 (13030)
Seat 5: Ayouki (5165)
Seat 6: charbon11 (11200)
Seat 7: maksuamet (7342)
Seat 8: Une_chaise (6140)
*** ANTE/BLINDS ***
almaju posts ante 75
427alligator posts ante 75
Lucho51_13 posts ante 75
manggy94 posts ante 75
Ayouki posts ante 75
charbon11 posts ante 75
maksuamet posts ante 75
Une_chaise posts ante 75
almaju posts small blind 400
427alligator posts big blind 800
Dealt to manggy94 [4h As]
*** PRE-FLOP *** 
manggy94 folds
Ayouki folds
charbon11 calls 800
maksuamet raises 6467 to 7267 and is all-in
Une_chaise folds
Lucho51_13 folds
almaju folds
427alligator folds
charbon11 folds
maksuamet collected 9867 from pot
*** SUMMARY ***
Total pot 9867 | No rake
Seat 7: maksuamet won 9867


Winamax Poker - Tournament "Kill The Fish" buyIn: 9€ + 1€ level: 10 - HandId: #713500187917549576-46-1471371399 - Holdem no limit (75/400/800) - 2016/08/16 18:16:39 UTC
Table: 'Kill The Fish(166124708)#007' 8-max (real money) Seat #2 is the button
Seat 1: Lucho51_13 (43685)
Seat 2: almaju (24583)
Seat 3: 427alligator (7430)
Seat 4: manggy94 (12955)
Seat 5: Ayouki (5090)
Seat 6: charbon11 (10325)
Seat 7: maksuamet (9867)
Seat 8: Une_chaise (6065)
*** ANTE/BLINDS ***
427alligator posts ante 75
manggy94 posts ante 75
Lucho51_13 posts ante 75
almaju posts ante 75
Ayouki posts ante 75
charbon11 posts ante 75
maksuamet posts ante 75
Une_chaise posts ante 75
427alligator posts small blind 400
manggy94 posts big blind 800
Dealt to manggy94 [2h 6d]
*** PRE-FLOP *** 
Ayouki calls 800
charbon11 calls 800
maksuamet raises 8992 to 9792 and is all-in
Une_chaise folds
Lucho51_13 calls 9792
almaju folds
427alligator folds
manggy94 folds
Ayouki folds
charbon11 raises 458 to 10250 and is all-in
Lucho51_13 calls 458
*** FLOP *** [Tc 3d Qs]
*** TURN *** [Tc 3d Qs][3c]
*** RIVER *** [Tc 3d Qs 3c][Ah]
*** SHOW DOWN ***
Lucho51_13 shows [Jd Kd] (Straight Ace high)
maksuamet shows [7h 7c] (Two pairs : 7 and 3)
charbon11 shows [Td Ts] (Full of Tens and 3)
charbon11 collected 32892 from pot
*** SUMMARY ***
Total pot 32892 | No rake
Board: [Tc 3d Qs 3c Ah]
Seat 1: Lucho51_13 showed [Jd Kd] and lost with Straight Ace high
Seat 6: charbon11 showed [Td Ts] and won 32892 with Full of Tens and 3
Seat 7: maksuamet showed [7h 7c] and lost with Two pairs : 7 and 3


Winamax Poker - Tournament "Kill The Fish" buyIn: 9€ + 1€ level: 10 - HandId: #713500187917549576-47-1471371447 - Holdem no limit (75/400/800) - 2016/08/16 18:17:27 UTC
Table: 'Kill The Fish(166124708)#007' 8-max (real money) Seat #3 is the button
Seat 1: Lucho51_13 (33360)
Seat 2: almaju (24508)
Seat 3: 427alligator (6955)
Seat 4: manggy94 (12080)
Seat 5: Ayouki (4215)
Seat 6: charbon11 (32892)
Seat 8: Une_chaise (5990)
*** ANTE/BLINDS ***
manggy94 posts ante 75
Ayouki posts ante 75
Lucho51_13 posts ante 75
almaju posts ante 75
427alligator posts ante 75
charbon11 posts ante 75
Une_chaise posts ante 75
manggy94 posts small blind 400
Ayouki posts big blind 800
Dealt to manggy94 [Kc 9c]
*** PRE-FLOP *** 
charbon11 calls 800
Une_chaise folds
Lucho51_13 calls 800
almaju folds
427alligator raises 6080 to 6880 and is all-in
manggy94 folds
Ayouki folds
charbon11 folds
Lucho51_13 calls 6080
*** FLOP *** [6d 2c Th]
*** TURN *** [6d 2c Th][Tc]
*** RIVER *** [6d 2c Th Tc][5h]
*** SHOW DOWN ***
Lucho51_13 shows [9s 8s] (One pair : Tens)
427alligator shows [Ah Qd] (One pair : Tens)
427alligator collected 16285 from pot
*** SUMMARY ***
Total pot 16285 | No rake
Board: [6d 2c Th Tc 5h]
Seat 1: Lucho51_13 showed [9s 8s] and lost with One pair : Tens
Seat 3: 427alligator (button) showed [Ah Qd] and won 16285 with One pair : Tens


Winamax Poker - Tournament "Kill The Fish" buyIn: 9€ + 1€ level: 10 - HandId: #713500187917549576-48-1471371497 - Holdem no limit (75/400/800) - 2016/08/16 18:18:17 UTC
Table: 'Kill The Fish(166124708)#007' 8-max (real money) Seat #4 is the button
Seat 1: Lucho51_13 (26405)
Seat 2: almaju (24433)
Seat 3: 427alligator (16285)
Seat 4: manggy94 (11605)
Seat 5: Ayouki (3340)
Seat 6: charbon11 (32017)
Seat 8: Une_chaise (5915)
*** ANTE/BLINDS ***
Ayouki posts ante 75
charbon11 posts ante 75
Lucho51_13 posts ante 75
almaju posts ante 75
427alligator posts ante 75
manggy94 posts ante 75
Une_chaise posts ante 75
Ayouki posts small blind 400
charbon11 posts big blind 800
Dealt to manggy94 [2d 4s]
*** PRE-FLOP *** 
Une_chaise folds
Lucho51_13 folds
almaju folds
427alligator folds
manggy94 folds
Ayouki folds
charbon11 collected 1725 from pot
*** SUMMARY ***
Total pot 1725 | No rake
Seat 6: charbon11 (big blind) won 1725


Winamax Poker - Tournament "Kill The Fish" buyIn: 9€ + 1€ level: 10 - HandId: #713500187917549576-49-1471371532 - Holdem no limit (75/400/800) - 2016/08/16 18:18:52 UTC
Table: 'Kill The Fish(166124708)#007' 8-max (real money) Seat #5 is the button
Seat 1: Lucho51_13 (26330)
Seat 2: almaju (24358)
Seat 3: 427alligator (16210)
Seat 4: manggy94 (11530)
Seat 5: Ayouki (2865)
Seat 6: charbon11 (32867)
Seat 8: Une_chaise (5840)
*** ANTE/BLINDS ***
charbon11 posts ante 75
Une_chaise posts ante 75
Lucho51_13 posts ante 75
almaju posts ante 75
427alligator posts ante 75
manggy94 posts ante 75
Ayouki posts ante 75
charbon11 posts small blind 400
Une_chaise posts big blind 800
Dealt to manggy94 [8d 6c]
*** PRE-FLOP *** 
Lucho51_13 folds
almaju folds
427alligator folds
manggy94 folds
Ayouki raises 1990 to 2790 and is all-in
charbon11 calls 2390
Une_chaise folds
*** FLOP *** [3d Ah 5h]
*** TURN *** [3d Ah 5h][Qd]
*** RIVER *** [3d Ah 5h Qd][Kd]
*** SHOW DOWN ***
charbon11 shows [9c Jc] (High card : Ace)
Ayouki shows [Qh Tc] (One pair : Queens)
Ayouki collected 6905 from pot
*** SUMMARY ***
Total pot 6905 | No rake
Board: [3d Ah 5h Qd Kd]
Seat 5: Ayouki (button) showed [Qh Tc] and won 6905 with One pair : Queens
Seat 6: charbon11 (small blind) showed [9c Jc] and lost with High card : Ace


Winamax Poker - Tournament "Kill The Fish" buyIn: 9€ + 1€ level: 10 - HandId: #713500187917549576-50-1471371580 - Holdem no limit (75/400/800) - 2016/08/16 18:19:40 UTC
Table: 'Kill The Fish(166124708)#007' 8-max (real money) Seat #6 is the button
Seat 1: Lucho51_13 (26255)
Seat 2: almaju (24283)
Seat 3: 427alligator (16135)
Seat 4: manggy94 (11455)
Seat 5: Ayouki (6905)
Seat 6: charbon11 (30002)
Seat 7: Graph.74 (12895)
Seat 8: Une_chaise (4965)
*** ANTE/BLINDS ***
Une_chaise posts ante 75
Lucho51_13 posts ante 75
almaju posts ante 75
427alligator posts ante 75
manggy94 posts ante 75
Ayouki posts ante 75
charbon11 posts ante 75
Une_chaise posts small blind 400
Lucho51_13 posts big blind 800
Dealt to manggy94 [3h 5s]
*** PRE-FLOP *** 
almaju folds
427alligator calls 800
manggy94 folds
Ayouki folds
charbon11 calls 800
Une_chaise folds
Lucho51_13 raises 2000 to 2800
427alligator folds
charbon11 calls 2000
*** FLOP *** [8c Qs Ks]
Lucho51_13 bets 23380 and is all-in
charbon11 folds
Lucho51_13 collected 30705 from pot
*** SUMMARY ***
Total pot 30705 | No rake
Board: [8c Qs Ks]
Seat 1: Lucho51_13 (big blind) won 30705


Winamax Poker - Tournament "Kill The Fish" buyIn: 9€ + 1€ level: 11 - HandId: #713500187917549576-51-1471371641 - Holdem no limit (100/500/1000) - 2016/08/16 18:20:41 UTC
Table: 'Kill The Fish(166124708)#007' 8-max (real money) Seat #8 is the button
Seat 1: Lucho51_13 (30705)
Seat 2: almaju (24208)
Seat 3: 427alligator (15260)
Seat 4: manggy94 (11380)
Seat 5: Ayouki (6830)
Seat 6: charbon11 (27127)
Seat 7: Graph.74 (12895)
Seat 8: Une_chaise (4490)
*** ANTE/BLINDS ***
Lucho51_13 posts ante 100
almaju posts ante 100
427alligator posts ante 100
manggy94 posts ante 100
Ayouki posts ante 100
charbon11 posts ante 100
Graph.74 posts ante 100
Une_chaise posts ante 100
Lucho51_13 posts small blind 500
almaju posts big blind 1000
Dealt to manggy94 [5s Th]
*** PRE-FLOP *** 
427alligator folds
manggy94 folds
Ayouki folds
charbon11 raises 1000 to 2000
Graph.74 folds
Une_chaise folds
Lucho51_13 calls 1500
almaju calls 1000
*** FLOP *** [7h 8d Kc]
Lucho51_13 checks
almaju bets 1500
charbon11 calls 1500
Lucho51_13 folds
*** TURN *** [7h 8d Kc][Jd]
almaju bets 1500
charbon11 calls 1500
*** RIVER *** [7h 8d Kc Jd][Ts]
almaju bets 3500
charbon11 raises 18527 to 22027 and is all-in
almaju calls 15608 and is all-in
*** SHOW DOWN ***
almaju shows [3c 9c] (Straight Jack high)
charbon11 shows [Td Tc] (Trips of Tens)
charbon11 collected 2919 from side pot 1
almaju collected 51016 from main pot
*** SUMMARY ***
Total pot 53935 | No rake
Board: [7h 8d Kc Jd Ts]
Seat 2: almaju (big blind) showed [3c 9c] and won 51016 with Straight Jack high
Seat 6: charbon11 showed [Td Tc] and won 2919 with Trips of Tens


Winamax Poker - Tournament "Kill The Fish" buyIn: 9€ + 1€ level: 11 - HandId: #713500187917549576-52-1471371732 - Holdem no limit (100/500/1000) - 2016/08/16 18:22:12 UTC
Table: 'Kill The Fish(166124708)#007' 8-max (real money) Seat #1 is the button
Seat 1: Lucho51_13 (28605)
Seat 2: almaju (51016)
Seat 3: 427alligator (15160)
Seat 4: manggy94 (11280)
Seat 5: Ayouki (6730)
Seat 6: charbon11 (2919)
Seat 7: Graph.74 (12795)
Seat 8: Une_chaise (4390)
*** ANTE/BLINDS ***
almaju posts ante 100
427alligator posts ante 100
Lucho51_13 posts ante 100
manggy94 posts ante 100
Ayouki posts ante 100
charbon11 posts ante 100
Graph.74 posts ante 100
Une_chaise posts ante 100
almaju posts small blind 500
427alligator posts big blind 1000
Dealt to manggy94 [As Qh]
*** PRE-FLOP *** 
manggy94 raises 2000 to 3000
Ayouki folds
charbon11 folds
Graph.74 folds
Une_chaise folds
Lucho51_13 folds
almaju folds
427alligator folds
manggy94 collected 5300 from pot
*** SUMMARY ***
Total pot 5300 | No rake
Seat 4: manggy94 won 5300


Winamax Poker - Tournament "Kill The Fish" buyIn: 9€ + 1€ level: 11 - HandId: #713500187917549576-53-1471371767 - Holdem no limit (100/500/1000) - 2016/08/16 18:22:47 UTC
Table: 'Kill The Fish(166124708)#007' 8-max (real money) Seat #2 is the button
Seat 1: Lucho51_13 (28505)
Seat 2: almaju (50416)
Seat 3: 427alligator (14060)
Seat 4: manggy94 (13480)
Seat 5: Ayouki (6630)
Seat 6: charbon11 (2819)
Seat 7: Graph.74 (12695)
Seat 8: Une_chaise (4290)
*** ANTE/BLINDS ***
427alligator posts ante 100
manggy94 posts ante 100
Lucho51_13 posts ante 100
almaju posts ante 100
Ayouki posts ante 100
charbon11 posts ante 100
Graph.74 posts ante 100
Une_chaise posts ante 100
427alligator posts small blind 500
manggy94 posts big blind 1000
Dealt to manggy94 [8s 4c]
*** PRE-FLOP *** 
Ayouki folds
charbon11 folds
Graph.74 folds
Une_chaise raises 3190 to 4190 and is all-in
Lucho51_13 folds
almaju calls 4190
427alligator folds
manggy94 folds
*** FLOP *** [Td 9d 8h]
*** TURN *** [Td 9d 8h][7s]
*** RIVER *** [Td 9d 8h 7s][Kc]
*** SHOW DOWN ***
Une_chaise shows [Ts 7c] (Two pairs : Tens and 7)
almaju shows [Qh Jc] (Straight King high)
almaju collected 10680 from pot
*** SUMMARY ***
Total pot 10680 | No rake
Board: [Td 9d 8h 7s Kc]
Seat 2: almaju (button) showed [Qh Jc] and won 10680 with Straight King high
Seat 8: Une_chaise showed [Ts 7c] and lost with Two pairs : Tens and 7


Winamax Poker - Tournament "Kill The Fish" buyIn: 9€ + 1€ level: 11 - HandId: #713500187917549576-54-1471371802 - Holdem no limit (100/500/1000) - 2016/08/16 18:23:22 UTC
Table: 'Kill The Fish(166124708)#007' 8-max (real money) Seat #3 is the button
Seat 1: Lucho51_13 (28405)
Seat 2: almaju (56806)
Seat 3: 427alligator (13460)
Seat 4: manggy94 (12380)
Seat 5: Ayouki (6530)
Seat 6: charbon11 (2719)
Seat 7: Graph.74 (12595)
*** ANTE/BLINDS ***
manggy94 posts ante 100
Ayouki posts ante 100
Lucho51_13 posts ante 100
almaju posts ante 100
427alligator posts ante 100
charbon11 posts ante 100
Graph.74 posts ante 100
manggy94 posts small blind 500
Ayouki posts big blind 1000
Dealt to manggy94 [3d Jh]
*** PRE-FLOP *** 
charbon11 raises 1619 to 2619 and is all-in
Graph.74 folds
Lucho51_13 folds
almaju folds
427alligator raises 10741 to 13360 and is all-in
manggy94 folds
Ayouki calls 5430 and is all-in
*** FLOP *** [Qc 5c 9s]
*** TURN *** [Qc 5c 9s][Jd]
*** RIVER *** [Qc 5c 9s Jd][5d]
*** SHOW DOWN ***
Ayouki shows [6d Ad] (One pair : 5)
427alligator shows [Ac 9c] (Two pairs : 9 and 5)
charbon11 shows [Kd Jc] (Two pairs : Jacks and 5)
charbon11 collected 9057 from main pot
427alligator collected 14552 from side pot 1
*** SUMMARY ***
Total pot 23609 | No rake
Board: [Qc 5c 9s Jd 5d]
Seat 3: 427alligator (button) showed [Ac 9c] and won 14552 with Two pairs : 9 and 5
Seat 5: Ayouki (big blind) showed [6d Ad] and lost with One pair : 5
Seat 6: charbon11 showed [Kd Jc] and won 9057 with Two pairs : Jacks and 5


Winamax Poker - Tournament "Kill The Fish" buyIn: 9€ + 1€ level: 11 - HandId: #713500187917549576-55-1471371828 - Holdem no limit (100/500/1000) - 2016/08/16 18:23:48 UTC
Table: 'Kill The Fish(166124708)#007' 8-max (real money) Seat #4 is the button
Seat 1: Lucho51_13 (28305)
Seat 2: almaju (56706)
Seat 3: 427alligator (14552)
Seat 4: manggy94 (11780)
Seat 6: charbon11 (9057)
Seat 7: Graph.74 (12495)
*** ANTE/BLINDS ***
charbon11 posts ante 100
Lucho51_13 posts ante 100
almaju posts ante 100
427alligator posts ante 100
manggy94 posts ante 100
Graph.74 posts ante 100
charbon11 posts big blind 1000
Dealt to manggy94 [5h Td]
*** PRE-FLOP *** 
Graph.74 folds
Lucho51_13 folds
almaju calls 1000
427alligator folds
manggy94 folds
charbon11 checks
*** FLOP *** [7c 8c 7s]
charbon11 checks
almaju checks
*** TURN *** [7c 8c 7s][3h]
charbon11 checks
almaju checks
*** RIVER *** [7c 8c 7s 3h][4d]
charbon11 bets 1300
almaju raises 2700 to 4000
charbon11 folds
almaju collected 7900 from pot
*** SUMMARY ***
Total pot 7900 | No rake
Board: [7c 8c 7s 3h 4d]
Seat 2: almaju won 7900


Winamax Poker - Tournament "Kill The Fish" buyIn: 9€ + 1€ level: 11 - HandId: #713500187917549576-56-1471371905 - Holdem no limit (100/500/1000) - 2016/08/16 18:25:05 UTC
Table: 'Kill The Fish(166124708)#007' 8-max (real money) Seat #5 is the button
Seat 1: Lucho51_13 (28205)
Seat 2: almaju (59506)
Seat 3: 427alligator (14452)
Seat 4: manggy94 (11680)
Seat 6: charbon11 (6657)
Seat 7: Graph.74 (12395)
*** ANTE/BLINDS ***
charbon11 posts ante 100
Graph.74 posts ante 100
Lucho51_13 posts ante 100
almaju posts ante 100
427alligator posts ante 100
manggy94 posts ante 100
charbon11 posts small blind 500
Graph.74 posts big blind 1000
Dealt to manggy94 [Jd Kh]
*** PRE-FLOP *** 
Lucho51_13 folds
almaju folds
427alligator folds
manggy94 raises 1000 to 2000
charbon11 folds
Graph.74 calls 1000
*** FLOP *** [3h 7h Ah]
Graph.74 checks
manggy94 bets 2550
Graph.74 folds
manggy94 collected 7650 from pot
*** SUMMARY ***
Total pot 7650 | No rake
Board: [3h 7h Ah]
Seat 4: manggy94 won 7650


Winamax Poker - Tournament "Kill The Fish" buyIn: 9€ + 1€ level: 11 - HandId: #713500187917549576-57-1471371947 - Holdem no limit (100/500/1000) - 2016/08/16 18:25:47 UTC
Table: 'Kill The Fish(166124708)#007' 8-max (real money) Seat #6 is the button
Seat 1: Lucho51_13 (28105)
Seat 2: almaju (59406)
Seat 3: 427alligator (14352)
Seat 4: manggy94 (14680)
Seat 5: SusuLaMif (12348)
Seat 6: charbon11 (6057)
Seat 7: Graph.74 (10295)
Seat 8: misty62btrd (17155)
*** ANTE/BLINDS ***
Graph.74 posts ante 100
misty62btrd posts ante 100
Lucho51_13 posts ante 100
almaju posts ante 100
427alligator posts ante 100
manggy94 posts ante 100
SusuLaMif posts ante 100
charbon11 posts ante 100
Graph.74 posts small blind 500
misty62btrd posts big blind 1000
Dealt to manggy94 [2h 8h]
*** PRE-FLOP *** 
Lucho51_13 folds
almaju folds
427alligator folds
manggy94 folds
SusuLaMif folds
charbon11 raises 4957 to 5957 and is all-in
Graph.74 calls 5457
misty62btrd folds
*** FLOP *** [2d Jh 2c]
*** TURN *** [2d Jh 2c][Ks]
*** RIVER *** [2d Jh 2c Ks][5c]
*** SHOW DOWN ***
Graph.74 shows [Ad 7d] (One pair : 2)
charbon11 shows [Kd Ac] (Two pairs : Kings and 2)
charbon11 collected 13714 from pot
*** SUMMARY ***
Total pot 13714 | No rake
Board: [2d Jh 2c Ks 5c]
Seat 6: charbon11 (button) showed [Kd Ac] and won 13714 with Two pairs : Kings and 2
Seat 7: Graph.74 (small blind) showed [Ad 7d] and lost with One pair : 2


Winamax Poker - Tournament "Kill The Fish" buyIn: 9€ + 1€ level: 12 - HandId: #713500187917549576-58-1471371991 - Holdem no limit (150/600/1200) - 2016/08/16 18:26:31 UTC
Table: 'Kill The Fish(166124708)#007' 8-max (real money) Seat #7 is the button
Seat 1: Lucho51_13 (28005)
Seat 2: almaju (59306)
Seat 3: 427alligator (14252)
Seat 4: manggy94 (14580)
Seat 5: SusuLaMif (12248)
Seat 6: charbon11 (13714)
Seat 7: Graph.74 (4238)
Seat 8: misty62btrd (16055)
*** ANTE/BLINDS ***
misty62btrd posts ante 150
Lucho51_13 posts ante 150
almaju posts ante 150
427alligator posts ante 150
manggy94 posts ante 150
SusuLaMif posts ante 150
charbon11 posts ante 150
Graph.74 posts ante 150
misty62btrd posts small blind 600
Lucho51_13 posts big blind 1200
Dealt to manggy94 [5d 9h]
*** PRE-FLOP *** 
almaju raises 1200 to 2400
427alligator folds
manggy94 folds
SusuLaMif folds
charbon11 folds
Graph.74 raises 1688 to 4088 and is all-in
misty62btrd calls 3488
Lucho51_13 calls 2888
almaju calls 1688
*** FLOP *** [3s 5s Qd]
misty62btrd bets 11817 and is all-in
Lucho51_13 folds
almaju folds
*** TURN *** [3s 5s Qd][6c]
*** RIVER *** [3s 5s Qd 6c][Js]
*** SHOW DOWN ***
Graph.74 shows [7c Ad] (High card : Ace)
misty62btrd shows [As Ah] (One pair : Aces)
misty62btrd collected 29369 from pot
*** SUMMARY ***
Total pot 29369 | No rake
Board: [3s 5s Qd 6c Js]
Seat 7: Graph.74 (button) showed [7c Ad] and lost with High card : Ace
Seat 8: misty62btrd (small blind) showed [As Ah] and won 29369 with One pair : Aces


Winamax Poker - Tournament "Kill The Fish" buyIn: 9€ + 1€ level: 12 - HandId: #713500187917549576-59-1471372052 - Holdem no limit (150/600/1200) - 2016/08/16 18:27:32 UTC
Table: 'Kill The Fish(166124708)#007' 8-max (real money) Seat #8 is the button
Seat 1: Lucho51_13 (23767)
Seat 2: almaju (55068)
Seat 3: 427alligator (14102)
Seat 4: manggy94 (14430)
Seat 5: SusuLaMif (12098)
Seat 6: charbon11 (13564)
Seat 8: misty62btrd (29369)
*** ANTE/BLINDS ***
Lucho51_13 posts ante 150
almaju posts ante 150
427alligator posts ante 150
manggy94 posts ante 150
SusuLaMif posts ante 150
charbon11 posts ante 150
misty62btrd posts ante 150
Lucho51_13 posts small blind 600
almaju posts big blind 1200
Dealt to manggy94 [4d 9d]
*** PRE-FLOP *** 
427alligator folds
manggy94 folds
SusuLaMif folds
charbon11 folds
misty62btrd folds
Lucho51_13 calls 600
almaju checks
*** FLOP *** [2d 6h Ac]
Lucho51_13 bets 1200
almaju calls 1200
*** TURN *** [2d 6h Ac][Qc]
Lucho51_13 bets 2400
almaju folds
Lucho51_13 collected 8250 from pot
*** SUMMARY ***
Total pot 8250 | No rake
Board: [2d 6h Ac Qc]
Seat 1: Lucho51_13 (small blind) won 8250


Winamax Poker - Tournament "Kill The Fish" buyIn: 9€ + 1€ level: 12 - HandId: #713500187917549576-60-1471372113 - Holdem no limit (150/600/1200) - 2016/08/16 18:28:33 UTC
Table: 'Kill The Fish(166124708)#007' 8-max (real money) Seat #1 is the button
Seat 1: Lucho51_13 (27067)
Seat 2: almaju (52518)
Seat 3: 427alligator (13952)
Seat 4: manggy94 (14280)
Seat 5: SusuLaMif (11948)
Seat 6: charbon11 (13414)
Seat 8: misty62btrd (29219)
*** ANTE/BLINDS ***
almaju posts ante 150
427alligator posts ante 150
Lucho51_13 posts ante 150
manggy94 posts ante 150
SusuLaMif posts ante 150
charbon11 posts ante 150
misty62btrd posts ante 150
almaju posts small blind 600
427alligator posts big blind 1200
Dealt to manggy94 [7d 9d]
*** PRE-FLOP *** 
manggy94 folds
SusuLaMif raises 10598 to 11798 and is all-in
charbon11 folds
misty62btrd folds
Lucho51_13 folds
almaju folds
427alligator folds
SusuLaMif collected 14648 from pot
*** SUMMARY ***
Total pot 14648 | No rake
Seat 5: SusuLaMif won 14648


Winamax Poker - Tournament "Kill The Fish" buyIn: 9€ + 1€ level: 12 - HandId: #713500187917549576-61-1471372140 - Holdem no limit (150/600/1200) - 2016/08/16 18:29:00 UTC
Table: 'Kill The Fish(166124708)#007' 8-max (real money) Seat #2 is the button
Seat 1: Lucho51_13 (26917)
Seat 2: almaju (51768)
Seat 3: 427alligator (12602)
Seat 4: manggy94 (14130)
Seat 5: SusuLaMif (14648)
Seat 6: charbon11 (13264)
Seat 8: misty62btrd (29069)
*** ANTE/BLINDS ***
427alligator posts ante 150
manggy94 posts ante 150
Lucho51_13 posts ante 150
almaju posts ante 150
SusuLaMif posts ante 150
charbon11 posts ante 150
misty62btrd posts ante 150
427alligator posts small blind 600
manggy94 posts big blind 1200
Dealt to manggy94 [2c 8d]
*** PRE-FLOP *** 
SusuLaMif folds
charbon11 folds
misty62btrd folds
Lucho51_13 calls 1200
almaju folds
427alligator folds
manggy94 checks
*** FLOP *** [8s Jd 3s]
manggy94 bets 1200
Lucho51_13 calls 1200
*** TURN *** [8s Jd 3s][5c]
manggy94 bets 1200
Lucho51_13 calls 1200
*** RIVER *** [8s Jd 3s 5c][2s]
manggy94 bets 10380 and is all-in
Lucho51_13 folds
manggy94 collected 19230 from pot
*** SUMMARY ***
Total pot 19230 | No rake
Board: [8s Jd 3s 5c 2s]
Seat 4: manggy94 (big blind) won 19230


Winamax Poker - Tournament "Kill The Fish" buyIn: 9€ + 1€ level: 12 - HandId: #713500187917549576-62-1471372215 - Holdem no limit (150/600/1200) - 2016/08/16 18:30:15 UTC
Table: 'Kill The Fish(166124708)#007' 8-max (real money) Seat #3 is the button
Seat 1: Lucho51_13 (23167)
Seat 2: almaju (51618)
Seat 3: 427alligator (11852)
Seat 4: manggy94 (19230)
Seat 5: SusuLaMif (14498)
Seat 6: charbon11 (13114)
Seat 8: misty62btrd (28919)
*** ANTE/BLINDS ***
manggy94 posts ante 150
SusuLaMif posts ante 150
Lucho51_13 posts ante 150
almaju posts ante 150
427alligator posts ante 150
charbon11 posts ante 150
misty62btrd posts ante 150
manggy94 posts small blind 600
SusuLaMif posts big blind 1200
Dealt to manggy94 [Qs 5s]
*** PRE-FLOP *** 
charbon11 raises 2400 to 3600
misty62btrd folds
Lucho51_13 folds
almaju folds
427alligator folds
manggy94 folds
SusuLaMif folds
charbon11 collected 6450 from pot
*** SUMMARY ***
Total pot 6450 | No rake
Seat 6: charbon11 won 6450


Winamax Poker - Tournament "Kill The Fish" buyIn: 9€ + 1€ level: 12 - HandId: #713500187917549576-63-1471372319 - Holdem no limit (150/600/1200) - 2016/08/16 18:31:59 UTC
Table: 'Kill The Fish(166124708)#007' 8-max (real money) Seat #4 is the button
Seat 1: Lucho51_13 (23017)
Seat 2: almaju (51468)
Seat 3: 427alligator (11702)
Seat 4: manggy94 (18480)
Seat 5: SusuLaMif (13148)
Seat 6: charbon11 (15814)
Seat 7: jesioletueur (27830)
Seat 8: misty62btrd (28769)
*** ANTE/BLINDS ***
SusuLaMif posts ante 150
charbon11 posts ante 150
Lucho51_13 posts ante 150
almaju posts ante 150
427alligator posts ante 150
manggy94 posts ante 150
jesioletueur posts ante 150
misty62btrd posts ante 150
SusuLaMif posts small blind 600
charbon11 posts big blind 1200
Dealt to manggy94 [As Ah]
*** PRE-FLOP *** 
jesioletueur folds
misty62btrd folds
Lucho51_13 folds
almaju folds
427alligator folds
manggy94 raises 4200 to 5400
SusuLaMif raises 7598 to 12998 and is all-in
charbon11 folds
manggy94 calls 7598
*** FLOP *** [7c 6h Ts]
*** TURN *** [7c 6h Ts][9s]
*** RIVER *** [7c 6h Ts 9s][Jd]
*** SHOW DOWN ***
SusuLaMif shows [Ad Jh] (One pair : Jacks)
manggy94 shows [As Ah] (One pair : Aces)
manggy94 collected 28396 from pot
*** SUMMARY ***
Total pot 28396 | No rake
Board: [7c 6h Ts 9s Jd]
Seat 4: manggy94 (button) showed [As Ah] and won 28396 with One pair : Aces
Seat 5: SusuLaMif (small blind) showed [Ad Jh] and lost with One pair : Jacks


Winamax Poker - Tournament "Kill The Fish" buyIn: 9€ + 1€ level: 13 - HandId: #713500187917549576-64-1471372381 - Holdem no limit (180/800/1600) - 2016/08/16 18:33:01 UTC
Table: 'Kill The Fish(166124708)#007' 8-max (real money) Seat #5 is the button
Seat 1: Lucho51_13 (22867)
Seat 2: almaju (51318)
Seat 3: 427alligator (11552)
Seat 4: manggy94 (33728)
Seat 6: charbon11 (14464)
Seat 7: jesioletueur (27680)
Seat 8: misty62btrd (28619)
*** ANTE/BLINDS ***
charbon11 posts ante 180
jesioletueur posts ante 180
Lucho51_13 posts ante 180
almaju posts ante 180
427alligator posts ante 180
manggy94 posts ante 180
misty62btrd posts ante 180
charbon11 posts small blind 800
jesioletueur posts big blind 1600
Dealt to manggy94 [Ac 8d]
*** PRE-FLOP *** 
misty62btrd folds
Lucho51_13 folds
almaju raises 2400 to 4000
427alligator folds
manggy94 folds
charbon11 folds
jesioletueur folds
almaju collected 7660 from pot
*** SUMMARY ***
Total pot 7660 | No rake
Seat 2: almaju won 7660


Winamax Poker - Tournament "Kill The Fish" buyIn: 9€ + 1€ level: 13 - HandId: #713500187917549576-65-1471372414 - Holdem no limit (180/800/1600) - 2016/08/16 18:33:34 UTC
Table: 'Kill The Fish(166124708)#007' 8-max (real money) Seat #6 is the button
Seat 1: Lucho51_13 (22687)
Seat 2: almaju (54798)
Seat 3: 427alligator (11372)
Seat 4: manggy94 (33548)
Seat 6: charbon11 (13484)
Seat 7: jesioletueur (25900)
Seat 8: misty62btrd (28439)
*** ANTE/BLINDS ***
jesioletueur posts ante 180
misty62btrd posts ante 180
Lucho51_13 posts ante 180
almaju posts ante 180
427alligator posts ante 180
manggy94 posts ante 180
charbon11 posts ante 180
jesioletueur posts small blind 800
misty62btrd posts big blind 1600
Dealt to manggy94 [4c 8d]
*** PRE-FLOP *** 
Lucho51_13 calls 1600
almaju calls 1600
427alligator folds
manggy94 folds
charbon11 calls 1600
jesioletueur calls 800
misty62btrd checks
*** FLOP *** [6s Td 5s]
jesioletueur checks
misty62btrd bets 1600
Lucho51_13 calls 1600
almaju folds
charbon11 folds
jesioletueur folds
*** TURN *** [6s Td 5s][Tc]
misty62btrd bets 1600
Lucho51_13 raises 4000 to 5600
misty62btrd folds
Lucho51_13 collected 19660 from pot
*** SUMMARY ***
Total pot 19660 | No rake
Board: [6s Td 5s Tc]
Seat 1: Lucho51_13 won 19660


Winamax Poker - Tournament "Kill The Fish" buyIn: 9€ + 1€ level: 13 - HandId: #713500187917549576-66-1471372494 - Holdem no limit (180/800/1600) - 2016/08/16 18:34:54 UTC
Table: 'Kill The Fish(166124708)#007' 8-max (real money) Seat #7 is the button
Seat 1: Lucho51_13 (33367)
Seat 2: almaju (53018)
Seat 3: 427alligator (11192)
Seat 4: manggy94 (33368)
Seat 6: charbon11 (11704)
Seat 7: jesioletueur (24120)
Seat 8: misty62btrd (23459)
*** ANTE/BLINDS ***
misty62btrd posts ante 180
Lucho51_13 posts ante 180
almaju posts ante 180
427alligator posts ante 180
manggy94 posts ante 180
charbon11 posts ante 180
jesioletueur posts ante 180
misty62btrd posts small blind 800
Lucho51_13 posts big blind 1600
Dealt to manggy94 [7d Ah]
*** PRE-FLOP *** 
almaju folds
427alligator folds
manggy94 raises 1600 to 3200
charbon11 raises 8324 to 11524 and is all-in
jesioletueur folds
misty62btrd folds
Lucho51_13 folds
manggy94 calls 8324
*** FLOP *** [Ad 7h Td]
*** TURN *** [Ad 7h Td][Qc]
*** RIVER *** [Ad 7h Td Qc][Kh]
*** SHOW DOWN ***
charbon11 shows [8d 8h] (One pair : 8)
manggy94 shows [7d Ah] (Two pairs : Aces and 7)
manggy94 collected 26708 from pot
*** SUMMARY ***
Total pot 26708 | No rake
Board: [Ad 7h Td Qc Kh]
Seat 4: manggy94 showed [7d Ah] and won 26708 with Two pairs : Aces and 7
Seat 6: charbon11 showed [8d 8h] and lost with One pair : 8


Winamax Poker - Tournament "Kill The Fish" buyIn: 9€ + 1€ level: 13 - HandId: #713500187917549576-67-1471372546 - Holdem no limit (180/800/1600) - 2016/08/16 18:35:46 UTC
Table: 'Kill The Fish(166124708)#007' 8-max (real money) Seat #8 is the button
Seat 1: Lucho51_13 (31587)
Seat 2: almaju (52838)
Seat 3: 427alligator (11012)
Seat 4: manggy94 (48372)
Seat 7: jesioletueur (23940)
Seat 8: misty62btrd (22479)
*** ANTE/BLINDS ***
Lucho51_13 posts ante 180
almaju posts ante 180
427alligator posts ante 180
manggy94 posts ante 180
jesioletueur posts ante 180
misty62btrd posts ante 180
Lucho51_13 posts small blind 800
almaju posts big blind 1600
Dealt to manggy94 [5h 4c]
*** PRE-FLOP *** 
427alligator folds
manggy94 folds
jesioletueur folds
misty62btrd folds
Lucho51_13 calls 800
almaju checks
*** FLOP *** [7d Ad As]
Lucho51_13 checks
almaju bets 2400
Lucho51_13 folds
almaju collected 6680 from pot
*** SUMMARY ***
Total pot 6680 | No rake
Board: [7d Ad As]
Seat 2: almaju (big blind) won 6680


Winamax Poker - Tournament "Kill The Fish" buyIn: 9€ + 1€ level: 13 - HandId: #713500187917549576-68-1471372609 - Holdem no limit (180/800/1600) - 2016/08/16 18:36:49 UTC
Table: 'Kill The Fish(166124708)#007' 8-max (real money) Seat #1 is the button
Seat 1: Lucho51_13 (29807)
Seat 2: almaju (55338)
Seat 3: 427alligator (10832)
Seat 4: manggy94 (48192)
Seat 5: JSscrub (38375)
Seat 6: cocs64 (30700)
Seat 7: jesioletueur (23760)
Seat 8: misty62btrd (22299)
*** ANTE/BLINDS ***
almaju posts ante 180
427alligator posts ante 180
Lucho51_13 posts ante 180
manggy94 posts ante 180
JSscrub posts ante 180
cocs64 posts ante 180
jesioletueur posts ante 180
misty62btrd posts ante 180
almaju posts small blind 800
427alligator posts big blind 1600
Dealt to manggy94 [8s 2c]
*** PRE-FLOP *** 
manggy94 folds
JSscrub folds
cocs64 folds
jesioletueur folds
misty62btrd folds
Lucho51_13 folds
almaju raises 2400 to 4000
427alligator raises 6652 to 10652 and is all-in
almaju calls 6652
*** FLOP *** [4c 7h 3h]
*** TURN *** [4c 7h 3h][3d]
*** RIVER *** [4c 7h 3h 3d][Ad]
*** SHOW DOWN ***
almaju shows [Ah Qd] (Two pairs : Aces and 3)
427alligator shows [Ac 4h] (Two pairs : Aces and 4)
427alligator collected 22744 from pot
*** SUMMARY ***
Total pot 22744 | No rake
Board: [4c 7h 3h 3d Ad]
Seat 2: almaju (small blind) showed [Ah Qd] and lost with Two pairs : Aces and 3
Seat 3: 427alligator (big blind) showed [Ac 4h] and won 22744 with Two pairs : Aces and 4


Winamax Poker - Tournament "Kill The Fish" buyIn: 9€ + 1€ level: 13 - HandId: #713500187917549576-69-1471372665 - Holdem no limit (180/800/1600) - 2016/08/16 18:37:45 UTC
Table: 'Kill The Fish(166124708)#007' 8-max (real money) Seat #2 is the button
Seat 1: Lucho51_13 (29627)
Seat 2: almaju (44506)
Seat 3: 427alligator (22744)
Seat 4: manggy94 (48012)
Seat 5: JSscrub (38195)
Seat 6: cocs64 (30520)
Seat 7: jesioletueur (23580)
Seat 8: misty62btrd (22119)
*** ANTE/BLINDS ***
427alligator posts ante 180
manggy94 posts ante 180
Lucho51_13 posts ante 180
almaju posts ante 180
JSscrub posts ante 180
cocs64 posts ante 180
jesioletueur posts ante 180
misty62btrd posts ante 180
427alligator posts small blind 800
manggy94 posts big blind 1600
Dealt to manggy94 [4h Jc]
*** PRE-FLOP *** 
JSscrub folds
cocs64 raises 1600 to 3200
jesioletueur folds
misty62btrd folds
Lucho51_13 folds
almaju folds
427alligator calls 2400
manggy94 folds
*** FLOP *** [Jd 7h Qs]
427alligator checks
cocs64 bets 4720
427alligator raises 4720 to 9440
cocs64 calls 4720
*** TURN *** [Jd 7h Qs][2c]
427alligator bets 9924 and is all-in
cocs64 calls 9924
*** RIVER *** [Jd 7h Qs 2c][6h]
*** SHOW DOWN ***
cocs64 shows [Js 9s] (One pair : Jacks)
427alligator shows [Kd Kc] (One pair : Kings)
427alligator collected 48168 from pot
*** SUMMARY ***
Total pot 48168 | No rake
Board: [Jd 7h Qs 2c 6h]
Seat 3: 427alligator (small blind) showed [Kd Kc] and won 48168 with One pair : Kings
Seat 6: cocs64 showed [Js 9s] and lost with One pair : Jacks


Winamax Poker - Tournament "Kill The Fish" buyIn: 9€ + 1€ level: 14 - HandId: #713500187917549576-70-1471372723 - Holdem no limit (240/1000/2000) - 2016/08/16 18:38:43 UTC
Table: 'Kill The Fish(166124708)#007' 8-max (real money) Seat #3 is the button
Seat 1: Lucho51_13 (29447)
Seat 2: almaju (44326)
Seat 3: 427alligator (48168)
Seat 4: manggy94 (46232)
Seat 5: JSscrub (38015)
Seat 6: cocs64 (7776)
Seat 7: jesioletueur (23400)
Seat 8: misty62btrd (21939)
*** ANTE/BLINDS ***
manggy94 posts ante 240
JSscrub posts ante 240
Lucho51_13 posts ante 240
almaju posts ante 240
427alligator posts ante 240
cocs64 posts ante 240
jesioletueur posts ante 240
misty62btrd posts ante 240
manggy94 posts small blind 1000
JSscrub posts big blind 2000
Dealt to manggy94 [3c Qd]
*** PRE-FLOP *** 
cocs64 folds
jesioletueur folds
misty62btrd folds
Lucho51_13 calls 2000
almaju raises 3000 to 5000
427alligator folds
manggy94 folds
JSscrub folds
Lucho51_13 calls 3000
*** FLOP *** [4c 8s Ah]
Lucho51_13 checks
almaju bets 6000
Lucho51_13 raises 18207 to 24207 and is all-in
almaju calls 18207
*** TURN *** [4c 8s Ah][4s]
*** RIVER *** [4c 8s Ah 4s][7d]
*** SHOW DOWN ***
Lucho51_13 shows [3h Ad] (Two pairs : Aces and 4)
almaju shows [Qh Ac] (Two pairs : Aces and 4)
almaju collected 63334 from pot
*** SUMMARY ***
Total pot 63334 | No rake
Board: [4c 8s Ah 4s 7d]
Seat 1: Lucho51_13 showed [3h Ad] and lost with Two pairs : Aces and 4
Seat 2: almaju showed [Qh Ac] and won 63334 with Two pairs : Aces and 4


Winamax Poker - Tournament "Kill The Fish" buyIn: 9€ + 1€ level: 14 - HandId: #713500187917549576-71-1471372809 - Holdem no limit (240/1000/2000) - 2016/08/16 18:40:09 UTC
Table: 'Kill The Fish(166124708)#007' 8-max (real money) Seat #4 is the button
Seat 2: almaju (78213)
Seat 3: 427alligator (47928)
Seat 4: manggy94 (44992)
Seat 5: JSscrub (35775)
Seat 6: cocs64 (7536)
Seat 7: jesioletueur (23160)
Seat 8: misty62btrd (21699)
*** ANTE/BLINDS ***
JSscrub posts ante 240
cocs64 posts ante 240
almaju posts ante 240
427alligator posts ante 240
manggy94 posts ante 240
jesioletueur posts ante 240
misty62btrd posts ante 240
JSscrub posts small blind 1000
cocs64 posts big blind 2000
Dealt to manggy94 [4h Js]
*** PRE-FLOP *** 
jesioletueur folds
misty62btrd folds
almaju calls 2000
427alligator folds
manggy94 folds
JSscrub folds
cocs64 checks
*** FLOP *** [8s Ts Jd]
cocs64 checks
almaju bets 3000
cocs64 raises 2296 to 5296 and is all-in
almaju calls 2296
*** TURN *** [8s Ts Jd][Th]
*** RIVER *** [8s Ts Jd Th][4s]
*** SHOW DOWN ***
almaju shows [3h 9h] (One pair : Tens)
cocs64 shows [Qd 7d] (One pair : Tens)
cocs64 collected 17272 from pot
*** SUMMARY ***
Total pot 17272 | No rake
Board: [8s Ts Jd Th 4s]
Seat 2: almaju showed [3h 9h] and lost with One pair : Tens
Seat 6: cocs64 (big blind) showed [Qd 7d] and won 17272 with One pair : Tens


Winamax Poker - Tournament "Kill The Fish" buyIn: 9€ + 1€ level: 14 - HandId: #713500187917549576-72-1471372889 - Holdem no limit (240/1000/2000) - 2016/08/16 18:41:29 UTC
Table: 'Kill The Fish(166124708)#007' 8-max (real money) Seat #5 is the button
Seat 2: almaju (70677)
Seat 3: 427alligator (47688)
Seat 4: manggy94 (44752)
Seat 5: JSscrub (34535)
Seat 6: cocs64 (17272)
Seat 7: jesioletueur (22920)
Seat 8: misty62btrd (21459)
*** ANTE/BLINDS ***
cocs64 posts ante 240
jesioletueur posts ante 240
almaju posts ante 240
427alligator posts ante 240
manggy94 posts ante 240
JSscrub posts ante 240
misty62btrd posts ante 240
cocs64 posts small blind 1000
jesioletueur posts big blind 2000
Dealt to manggy94 [6d Qs]
*** PRE-FLOP *** 
misty62btrd folds
almaju folds
427alligator folds
manggy94 folds
JSscrub folds
cocs64 raises 15032 to 17032 and is all-in
jesioletueur folds
cocs64 collected 20712 from pot
*** SUMMARY ***
Total pot 20712 | No rake
Seat 6: cocs64 (small blind) won 20712


Winamax Poker - Tournament "Kill The Fish" buyIn: 9€ + 1€ level: 14 - HandId: #713500187917549569-96-1471372990 - Holdem no limit (240/1000/2000) - 2016/08/16 18:43:10 UTC
Table: 'Kill The Fish(166124708)#000' 8-max (real money) Seat #8 is the button
Seat 1: JimmyGadel (21092)
Seat 2: ANTEATER555 (161788)
Seat 3: Lilidou14 (60820)
Seat 4: CLEMA (29552)
Seat 5: manggy94 (44512)
Seat 6: See U N T (122607)
Seat 7: cocs64 (20712)
Seat 8: Stoufims (36715)
*** ANTE/BLINDS ***
JimmyGadel posts ante 240
ANTEATER555 posts ante 240
Lilidou14 posts ante 240
CLEMA posts ante 240
manggy94 posts ante 240
See U N T posts ante 240
cocs64 posts ante 240
Stoufims posts ante 240
JimmyGadel posts small blind 1000
ANTEATER555 posts big blind 2000
Dealt to manggy94 [6s Td]
*** PRE-FLOP *** 
Lilidou14 folds
CLEMA folds
manggy94 folds
See U N T raises 2200 to 4200
cocs64 folds
Stoufims folds
JimmyGadel folds
ANTEATER555 folds
See U N T collected 9120 from pot
*** SUMMARY ***
Total pot 9120 | No rake
Seat 6: See U N T won 9120


Winamax Poker - Tournament "Kill The Fish" buyIn: 9€ + 1€ level: 15 - HandId: #713500187917549569-97-1471373089 - Holdem no limit (320/1250/2500) - 2016/08/16 18:44:49 UTC
Table: 'Kill The Fish(166124708)#000' 8-max (real money) Seat #1 is the button
Seat 1: JimmyGadel (19852)
Seat 2: ANTEATER555 (159548)
Seat 3: Lilidou14 (60580)
Seat 4: CLEMA (29312)
Seat 5: manggy94 (44272)
Seat 6: See U N T (127287)
Seat 7: cocs64 (20472)
Seat 8: Stoufims (36475)
*** ANTE/BLINDS ***
ANTEATER555 posts ante 320
Lilidou14 posts ante 320
JimmyGadel posts ante 320
CLEMA posts ante 320
manggy94 posts ante 320
See U N T posts ante 320
cocs64 posts ante 320
Stoufims posts ante 320
ANTEATER555 posts small blind 1250
Lilidou14 posts big blind 2500
Dealt to manggy94 [Th 4d]
*** PRE-FLOP *** 
CLEMA folds
manggy94 folds
See U N T raises 3025 to 5525
cocs64 folds
Stoufims folds
JimmyGadel raises 14007 to 19532 and is all-in
ANTEATER555 folds
Lilidou14 folds
See U N T calls 14007
*** FLOP *** [9s Ad 2s]
*** TURN *** [9s Ad 2s][Qh]
*** RIVER *** [9s Ad 2s Qh][7c]
*** SHOW DOWN ***
See U N T shows [8d 8c] (One pair : 8)
JimmyGadel shows [Kd Qd] (One pair : Queens)
JimmyGadel collected 45374 from pot
*** SUMMARY ***
Total pot 45374 | No rake
Board: [9s Ad 2s Qh 7c]
Seat 1: JimmyGadel (button) showed [Kd Qd] and won 45374 with One pair : Queens
Seat 6: See U N T showed [8d 8c] and lost with One pair : 8


Winamax Poker - Tournament "Kill The Fish" buyIn: 9€ + 1€ level: 15 - HandId: #713500187917549569-98-1471373162 - Holdem no limit (320/1250/2500) - 2016/08/16 18:46:02 UTC
Table: 'Kill The Fish(166124708)#000' 8-max (real money) Seat #2 is the button
Seat 1: JimmyGadel (45374)
Seat 2: ANTEATER555 (157978)
Seat 3: Lilidou14 (57760)
Seat 4: CLEMA (28992)
Seat 5: manggy94 (43952)
Seat 6: See U N T (107435)
Seat 7: cocs64 (20152)
Seat 8: Stoufims (36155)
*** ANTE/BLINDS ***
Lilidou14 posts ante 320
CLEMA posts ante 320
JimmyGadel posts ante 320
ANTEATER555 posts ante 320
manggy94 posts ante 320
See U N T posts ante 320
cocs64 posts ante 320
Stoufims posts ante 320
Lilidou14 posts small blind 1250
CLEMA posts big blind 2500
Dealt to manggy94 [5d 7h]
*** PRE-FLOP *** 
manggy94 folds
See U N T folds
cocs64 folds
Stoufims folds
JimmyGadel folds
ANTEATER555 folds
Lilidou14 raises 54940 to 57440 and is all-in
CLEMA folds
Lilidou14 collected 62500 from pot
*** SUMMARY ***
Total pot 62500 | No rake
Seat 3: Lilidou14 (small blind) won 62500


Winamax Poker - Tournament "Kill The Fish" buyIn: 9€ + 1€ level: 15 - HandId: #713500187917549569-99-1471373200 - Holdem no limit (320/1250/2500) - 2016/08/16 18:46:40 UTC
Table: 'Kill The Fish(166124708)#000' 8-max (real money) Seat #3 is the button
Seat 1: JimmyGadel (45054)
Seat 2: ANTEATER555 (157658)
Seat 3: Lilidou14 (62500)
Seat 4: CLEMA (26172)
Seat 5: manggy94 (43632)
Seat 6: See U N T (107115)
Seat 7: cocs64 (19832)
Seat 8: Stoufims (35835)
*** ANTE/BLINDS ***
CLEMA posts ante 320
manggy94 posts ante 320
JimmyGadel posts ante 320
ANTEATER555 posts ante 320
Lilidou14 posts ante 320
See U N T posts ante 320
cocs64 posts ante 320
Stoufims posts ante 320
CLEMA posts small blind 1250
manggy94 posts big blind 2500
Dealt to manggy94 [Qc 4h]
*** PRE-FLOP *** 
See U N T folds
cocs64 folds
Stoufims raises 3025 to 5525
JimmyGadel folds
ANTEATER555 calls 5525
Lilidou14 folds
CLEMA folds
manggy94 folds
*** FLOP *** [Ad Ah 8s]
Stoufims checks
ANTEATER555 checks
*** TURN *** [Ad Ah 8s][9d]
Stoufims bets 5034
ANTEATER555 folds
Stoufims collected 22394 from pot
*** SUMMARY ***
Total pot 22394 | No rake
Board: [Ad Ah 8s 9d]
Seat 8: Stoufims won 22394


Winamax Poker - Tournament "Kill The Fish" buyIn: 9€ + 1€ level: 15 - HandId: #713500187917549569-100-1471373259 - Holdem no limit (320/1250/2500) - 2016/08/16 18:47:39 UTC
Table: 'Kill The Fish(166124708)#000' 8-max (real money) Seat #4 is the button
Seat 1: JimmyGadel (44734)
Seat 2: ANTEATER555 (151813)
Seat 3: Lilidou14 (62180)
Seat 4: CLEMA (24602)
Seat 5: manggy94 (40812)
Seat 6: See U N T (106795)
Seat 7: cocs64 (19512)
Seat 8: Stoufims (47350)
*** ANTE/BLINDS ***
manggy94 posts ante 320
See U N T posts ante 320
JimmyGadel posts ante 320
ANTEATER555 posts ante 320
Lilidou14 posts ante 320
CLEMA posts ante 320
cocs64 posts ante 320
Stoufims posts ante 320
manggy94 posts small blind 1250
See U N T posts big blind 2500
Dealt to manggy94 [7s 2c]
*** PRE-FLOP *** 
cocs64 folds
Stoufims folds
JimmyGadel folds
ANTEATER555 folds
Lilidou14 folds
CLEMA raises 21782 to 24282 and is all-in
manggy94 folds
See U N T folds
CLEMA collected 30592 from pot
*** SUMMARY ***
Total pot 30592 | No rake
Seat 4: CLEMA (button) won 30592


Winamax Poker - Tournament "Kill The Fish" buyIn: 9€ + 1€ level: 15 - HandId: #713500187917549569-101-1471373309 - Holdem no limit (320/1250/2500) - 2016/08/16 18:48:29 UTC
Table: 'Kill The Fish(166124708)#000' 8-max (real money) Seat #5 is the button
Seat 1: JimmyGadel (44414)
Seat 2: ANTEATER555 (151493)
Seat 3: Lilidou14 (61860)
Seat 4: CLEMA (30592)
Seat 5: manggy94 (39242)
Seat 6: See U N T (103975)
Seat 7: cocs64 (19192)
*** ANTE/BLINDS ***
See U N T posts ante 320
cocs64 posts ante 320
JimmyGadel posts ante 320
ANTEATER555 posts ante 320
Lilidou14 posts ante 320
CLEMA posts ante 320
manggy94 posts ante 320
See U N T posts small blind 1250
cocs64 posts big blind 2500
Dealt to manggy94 [8s Ks]
*** PRE-FLOP *** 
JimmyGadel folds
ANTEATER555 folds
Lilidou14 folds
CLEMA raises 27772 to 30272 and is all-in
manggy94 folds
See U N T folds
cocs64 calls 16372 and is all-in
*** FLOP *** [5s 9h 5c]
*** TURN *** [5s 9h 5c][9s]
*** RIVER *** [5s 9h 5c 9s][2h]
*** SHOW DOWN ***
CLEMA shows [6h 6c] (Two pairs : 9 and 6)
cocs64 shows [Tc Th] (Two pairs : Tens and 9)
cocs64 collected 41234 from main pot
CLEMA collected 11400 from side pot 1
*** SUMMARY ***
Total pot 52634 | No rake
Board: [5s 9h 5c 9s 2h]
Seat 4: CLEMA showed [6h 6c] and won 11400 with Two pairs : 9 and 6
Seat 7: cocs64 (big blind) showed [Tc Th] and won 41234 with Two pairs : Tens and 9


Winamax Poker - Tournament "Kill The Fish" buyIn: 9€ + 1€ level: 15 - HandId: #713500187917549569-102-1471373355 - Holdem no limit (320/1250/2500) - 2016/08/16 18:49:15 UTC
Table: 'Kill The Fish(166124708)#000' 8-max (real money) Seat #6 is the button
Seat 1: JimmyGadel (44094)
Seat 2: ANTEATER555 (151173)
Seat 3: Lilidou14 (61540)
Seat 4: CLEMA (11400)
Seat 5: manggy94 (38922)
Seat 6: See U N T (102405)
Seat 7: cocs64 (41234)
*** ANTE/BLINDS ***
cocs64 posts ante 320
JimmyGadel posts ante 320
ANTEATER555 posts ante 320
Lilidou14 posts ante 320
CLEMA posts ante 320
manggy94 posts ante 320
See U N T posts ante 320
cocs64 posts small blind 1250
JimmyGadel posts big blind 2500
Dealt to manggy94 [7d 6s]
*** PRE-FLOP *** 
ANTEATER555 folds
Lilidou14 folds
CLEMA folds
manggy94 folds
See U N T raises 2750 to 5250
cocs64 folds
JimmyGadel folds
See U N T collected 11240 from pot
*** SUMMARY ***
Total pot 11240 | No rake
Seat 6: See U N T (button) won 11240


Winamax Poker - Tournament "Kill The Fish" buyIn: 9€ + 1€ level: 16 - HandId: #713500187917549569-103-1471373428 - Holdem no limit (430/1500/3000) - 2016/08/16 18:50:28 UTC
Table: 'Kill The Fish(166124708)#000' 8-max (real money) Seat #7 is the button
Seat 1: JimmyGadel (41274)
Seat 2: ANTEATER555 (150853)
Seat 3: Lilidou14 (61220)
Seat 4: CLEMA (11080)
Seat 5: manggy94 (38602)
Seat 6: See U N T (108075)
Seat 7: cocs64 (39664)
*** ANTE/BLINDS ***
JimmyGadel posts ante 430
ANTEATER555 posts ante 430
Lilidou14 posts ante 430
CLEMA posts ante 430
manggy94 posts ante 430
See U N T posts ante 430
cocs64 posts ante 430
JimmyGadel posts small blind 1500
ANTEATER555 posts big blind 3000
Dealt to manggy94 [6c 4d]
*** PRE-FLOP *** 
Lilidou14 folds
CLEMA folds
manggy94 folds
See U N T folds
cocs64 raises 6000 to 9000
JimmyGadel folds
ANTEATER555 folds
cocs64 collected 16510 from pot
*** SUMMARY ***
Total pot 16510 | No rake
Seat 7: cocs64 (button) won 16510


Winamax Poker - Tournament "Kill The Fish" buyIn: 9€ + 1€ level: 16 - HandId: #713500187917549569-104-1471373445 - Holdem no limit (430/1500/3000) - 2016/08/16 18:50:45 UTC
Table: 'Kill The Fish(166124708)#000' 8-max (real money) Seat #1 is the button
Seat 1: JimmyGadel (39344)
Seat 2: ANTEATER555 (147423)
Seat 3: Lilidou14 (60790)
Seat 4: CLEMA (10650)
Seat 5: manggy94 (38172)
Seat 6: See U N T (107645)
Seat 7: cocs64 (46744)
Seat 8: alober76 (19528)
*** ANTE/BLINDS ***
ANTEATER555 posts ante 430
Lilidou14 posts ante 430
JimmyGadel posts ante 430
CLEMA posts ante 430
manggy94 posts ante 430
See U N T posts ante 430
cocs64 posts ante 430
alober76 posts ante 430
ANTEATER555 posts small blind 1500
Lilidou14 posts big blind 3000
Dealt to manggy94 [9c 6s]
*** PRE-FLOP *** 
CLEMA folds
manggy94 folds
See U N T raises 3300 to 6300
cocs64 folds
alober76 folds
JimmyGadel folds
ANTEATER555 folds
Lilidou14 calls 3300
*** FLOP *** [2d As 8h]
Lilidou14 checks
See U N T bets 6665
Lilidou14 folds
See U N T collected 24205 from pot
*** SUMMARY ***
Total pot 24205 | No rake
Board: [2d As 8h]
Seat 6: See U N T won 24205


Winamax Poker - Tournament "Kill The Fish" buyIn: 9€ + 1€ level: 16 - HandId: #713500187917549569-105-1471373495 - Holdem no limit (430/1500/3000) - 2016/08/16 18:51:35 UTC
Table: 'Kill The Fish(166124708)#000' 8-max (real money) Seat #2 is the button
Seat 1: JimmyGadel (38914)
Seat 2: ANTEATER555 (145493)
Seat 3: Lilidou14 (54060)
Seat 4: CLEMA (10220)
Seat 5: manggy94 (37742)
Seat 6: See U N T (118455)
Seat 7: cocs64 (46314)
Seat 8: alober76 (19098)
*** ANTE/BLINDS ***
Lilidou14 posts ante 430
CLEMA posts ante 430
JimmyGadel posts ante 430
ANTEATER555 posts ante 430
manggy94 posts ante 430
See U N T posts ante 430
cocs64 posts ante 430
alober76 posts ante 430
Lilidou14 posts small blind 1500
CLEMA posts big blind 3000
Dealt to manggy94 [3d Ah]
*** PRE-FLOP *** 
manggy94 folds
See U N T folds
cocs64 folds
alober76 folds
JimmyGadel raises 35484 to 38484 and is all-in
ANTEATER555 folds
Lilidou14 folds
CLEMA calls 6790 and is all-in
*** FLOP *** [6s 9d 6d]
*** TURN *** [6s 9d 6d][7s]
*** RIVER *** [6s 9d 6d 7s][6c]
*** SHOW DOWN ***
JimmyGadel shows [4s 4h] (Full of 6 and 4)
CLEMA shows [7c 8c] (Full of 6 and 7)
CLEMA collected 24520 from main pot
JimmyGadel collected 28694 from side pot 1
*** SUMMARY ***
Total pot 53214 | No rake
Board: [6s 9d 6d 7s 6c]
Seat 1: JimmyGadel showed [4s 4h] and won 28694 with Full of 6 and 4
Seat 4: CLEMA (big blind) showed [7c 8c] and won 24520 with Full of 6 and 7


Winamax Poker - Tournament "Kill The Fish" buyIn: 9€ + 1€ level: 16 - HandId: #713500187917549569-106-1471373543 - Holdem no limit (430/1500/3000) - 2016/08/16 18:52:23 UTC
Table: 'Kill The Fish(166124708)#000' 8-max (real money) Seat #3 is the button
Seat 1: JimmyGadel (28694)
Seat 2: ANTEATER555 (145063)
Seat 3: Lilidou14 (52130)
Seat 4: CLEMA (24520)
Seat 5: manggy94 (37312)
Seat 6: See U N T (118025)
Seat 7: cocs64 (45884)
Seat 8: alober76 (18668)
*** ANTE/BLINDS ***
CLEMA posts ante 430
manggy94 posts ante 430
JimmyGadel posts ante 430
ANTEATER555 posts ante 430
Lilidou14 posts ante 430
See U N T posts ante 430
cocs64 posts ante 430
alober76 posts ante 430
CLEMA posts small blind 1500
manggy94 posts big blind 3000
Dealt to manggy94 [2h 6s]
*** PRE-FLOP *** 
See U N T folds
cocs64 folds
alober76 folds
JimmyGadel folds
ANTEATER555 folds
Lilidou14 raises 48700 to 51700 and is all-in
CLEMA folds
manggy94 folds
Lilidou14 collected 59640 from pot
*** SUMMARY ***
Total pot 59640 | No rake
Seat 3: Lilidou14 (button) won 59640


Winamax Poker - Tournament "Kill The Fish" buyIn: 9€ + 1€ level: 16 - HandId: #713500187917549569-107-1471373589 - Holdem no limit (430/1500/3000) - 2016/08/16 18:53:09 UTC
Table: 'Kill The Fish(166124708)#000' 8-max (real money) Seat #4 is the button
Seat 1: JimmyGadel (28264)
Seat 2: ANTEATER555 (144633)
Seat 3: Lilidou14 (59640)
Seat 4: CLEMA (22590)
Seat 5: manggy94 (33882)
Seat 6: See U N T (117595)
Seat 7: cocs64 (45454)
Seat 8: alober76 (18238)
*** ANTE/BLINDS ***
manggy94 posts ante 430
See U N T posts ante 430
JimmyGadel posts ante 430
ANTEATER555 posts ante 430
Lilidou14 posts ante 430
CLEMA posts ante 430
cocs64 posts ante 430
alober76 posts ante 430
manggy94 posts small blind 1500
See U N T posts big blind 3000
Dealt to manggy94 [Jd Kh]
*** PRE-FLOP *** 
cocs64 folds
alober76 folds
JimmyGadel folds
ANTEATER555 raises 141203 to 144203 and is all-in
Lilidou14 folds
CLEMA folds
manggy94 folds
See U N T folds
ANTEATER555 collected 152143 from pot
*** SUMMARY ***
Total pot 152143 | No rake
Seat 2: ANTEATER555 won 152143


Winamax Poker - Tournament "Kill The Fish" buyIn: 9€ + 1€ level: 16 - HandId: #713500187917549569-108-1471373668 - Holdem no limit (430/1500/3000) - 2016/08/16 18:54:28 UTC
Table: 'Kill The Fish(166124708)#000' 8-max (real money) Seat #5 is the button
Seat 1: JimmyGadel (27834)
Seat 2: ANTEATER555 (152143)
Seat 3: Lilidou14 (59210)
Seat 4: CLEMA (22160)
Seat 5: manggy94 (31952)
Seat 6: See U N T (114165)
Seat 7: cocs64 (45024)
Seat 8: alober76 (17808)
*** ANTE/BLINDS ***
See U N T posts ante 430
cocs64 posts ante 430
JimmyGadel posts ante 430
ANTEATER555 posts ante 430
Lilidou14 posts ante 430
CLEMA posts ante 430
manggy94 posts ante 430
alober76 posts ante 430
See U N T posts small blind 1500
cocs64 posts big blind 3000
Dealt to manggy94 [7d 4c]
*** PRE-FLOP *** 
alober76 folds
JimmyGadel folds
ANTEATER555 folds
Lilidou14 folds
CLEMA folds
manggy94 folds
See U N T calls 1500
cocs64 checks
*** FLOP *** [Js 5d Kd]
See U N T bets 4437
cocs64 folds
See U N T collected 13877 from pot
*** SUMMARY ***
Total pot 13877 | No rake
Board: [Js 5d Kd]
Seat 6: See U N T (small blind) won 13877


Winamax Poker - Tournament "Kill The Fish" buyIn: 9€ + 1€ level: 16 - HandId: #713500187917549569-109-1471374002 - Holdem no limit (430/1500/3000) - 2016/08/16 19:00:02 UTC
Table: 'Kill The Fish(166124708)#000' 8-max (real money) Seat #6 is the button
Seat 1: JimmyGadel (27404)
Seat 2: ANTEATER555 (151713)
Seat 3: Lilidou14 (58780)
Seat 4: CLEMA (21730)
Seat 5: manggy94 (31522)
Seat 6: See U N T (120175)
Seat 7: cocs64 (41594)
Seat 8: alober76 (17378)
*** ANTE/BLINDS ***
cocs64 posts ante 430
alober76 posts ante 430
JimmyGadel posts ante 430
ANTEATER555 posts ante 430
Lilidou14 posts ante 430
CLEMA posts ante 430
manggy94 posts ante 430
See U N T posts ante 430
cocs64 posts small blind 1500
alober76 posts big blind 3000
Dealt to manggy94 [Th 4c]
*** PRE-FLOP *** 
JimmyGadel folds
ANTEATER555 folds
Lilidou14 folds
CLEMA folds
manggy94 folds
See U N T raises 3300 to 6300
cocs64 folds
alober76 calls 3300
*** FLOP *** [5h Kd 6d]
alober76 checks
See U N T bets 113445 and is all-in
alober76 folds
See U N T collected 130985 from pot
*** SUMMARY ***
Total pot 130985 | No rake
Board: [5h Kd 6d]
Seat 6: See U N T (button) won 130985


Winamax Poker - Tournament "Kill The Fish" buyIn: 9€ + 1€ level: 17 - HandId: #713500187917549569-110-1471374066 - Holdem no limit (500/2000/4000) - 2016/08/16 19:01:06 UTC
Table: 'Kill The Fish(166124708)#000' 8-max (real money) Seat #7 is the button
Seat 1: JimmyGadel (26974)
Seat 2: ANTEATER555 (151283)
Seat 3: Lilidou14 (58350)
Seat 4: CLEMA (21300)
Seat 5: manggy94 (31092)
Seat 6: See U N T (130985)
Seat 7: cocs64 (39664)
Seat 8: alober76 (10648)
*** ANTE/BLINDS ***
alober76 posts ante 500
JimmyGadel posts ante 500
ANTEATER555 posts ante 500
Lilidou14 posts ante 500
CLEMA posts ante 500
manggy94 posts ante 500
See U N T posts ante 500
cocs64 posts ante 500
alober76 posts small blind 2000
JimmyGadel posts big blind 4000
Dealt to manggy94 [8h 2d]
*** PRE-FLOP *** 
ANTEATER555 folds
Lilidou14 folds
CLEMA raises 16800 to 20800 and is all-in
manggy94 folds
See U N T folds
cocs64 folds
alober76 calls 8148 and is all-in
JimmyGadel folds
*** FLOP *** [9h Qd 7c]
*** TURN *** [9h Qd 7c][7d]
*** RIVER *** [9h Qd 7c 7d][Td]
*** SHOW DOWN ***
CLEMA shows [Kh As] (One pair : 7)
alober76 shows [Qs 5s] (Two pairs : Queens and 7)
alober76 collected 28296 from main pot
CLEMA collected 10652 from side pot 1
*** SUMMARY ***
Total pot 38948 | No rake
Board: [9h Qd 7c 7d Td]
Seat 4: CLEMA showed [Kh As] and won 10652 with One pair : 7
Seat 8: alober76 (small blind) showed [Qs 5s] and won 28296 with Two pairs : Queens and 7


Winamax Poker - Tournament "Kill The Fish" buyIn: 9€ + 1€ level: 17 - HandId: #713500187917549569-111-1471374109 - Holdem no limit (500/2000/4000) - 2016/08/16 19:01:49 UTC
Table: 'Kill The Fish(166124708)#000' 8-max (real money) Seat #8 is the button
Seat 1: JimmyGadel (22474)
Seat 2: ANTEATER555 (150783)
Seat 3: Lilidou14 (57850)
Seat 4: CLEMA (10652)
Seat 5: manggy94 (30592)
Seat 6: See U N T (130485)
Seat 7: cocs64 (39164)
Seat 8: alober76 (28296)
*** ANTE/BLINDS ***
JimmyGadel posts ante 500
ANTEATER555 posts ante 500
Lilidou14 posts ante 500
CLEMA posts ante 500
manggy94 posts ante 500
See U N T posts ante 500
cocs64 posts ante 500
alober76 posts ante 500
JimmyGadel posts small blind 2000
ANTEATER555 posts big blind 4000
Dealt to manggy94 [2h 4d]
*** PRE-FLOP *** 
Lilidou14 folds
CLEMA folds
manggy94 folds
See U N T folds
cocs64 folds
alober76 folds
JimmyGadel raises 17974 to 21974 and is all-in
ANTEATER555 calls 17974
*** FLOP *** [Th Tc 4s]
*** TURN *** [Th Tc 4s][2s]
*** RIVER *** [Th Tc 4s 2s][8d]
*** SHOW DOWN ***
JimmyGadel shows [9d 6d] (One pair : Tens)
ANTEATER555 shows [Jh Ks] (One pair : Tens)
ANTEATER555 collected 47948 from pot
*** SUMMARY ***
Total pot 47948 | No rake
Board: [Th Tc 4s 2s 8d]
Seat 1: JimmyGadel (small blind) showed [9d 6d] and lost with One pair : Tens
Seat 2: ANTEATER555 (big blind) showed [Jh Ks] and won 47948 with One pair : Tens


Winamax Poker - Tournament "Kill The Fish" buyIn: 9€ + 1€ level: 17 - HandId: #713500187917549569-112-1471374156 - Holdem no limit (500/2000/4000) - 2016/08/16 19:02:36 UTC
Table: 'Kill The Fish(166124708)#000' 8-max (real money) Seat #1 is the button
Seat 2: ANTEATER555 (176257)
Seat 3: Lilidou14 (57350)
Seat 4: CLEMA (10152)
Seat 5: manggy94 (30092)
Seat 6: See U N T (129985)
Seat 7: cocs64 (38664)
Seat 8: alober76 (27796)
*** ANTE/BLINDS ***
ANTEATER555 posts ante 500
Lilidou14 posts ante 500
CLEMA posts ante 500
manggy94 posts ante 500
See U N T posts ante 500
cocs64 posts ante 500
alober76 posts ante 500
ANTEATER555 posts small blind 2000
Lilidou14 posts big blind 4000
Dealt to manggy94 [Jc 4h]
*** PRE-FLOP *** 
CLEMA folds
manggy94 folds
See U N T raises 4400 to 8400
cocs64 folds
alober76 folds
ANTEATER555 raises 16129 to 24529
Lilidou14 folds
See U N T calls 16129
*** FLOP *** [Ks 9s 3s]
ANTEATER555 checks
See U N T bets 48000
ANTEATER555 folds
See U N T collected 104558 from pot
*** SUMMARY ***
Total pot 104558 | No rake
Board: [Ks 9s 3s]
Seat 6: See U N T won 104558


Winamax Poker - Tournament "Kill The Fish" buyIn: 9€ + 1€ level: 17 - HandId: #713500187917549569-113-1471374216 - Holdem no limit (500/2000/4000) - 2016/08/16 19:03:36 UTC
Table: 'Kill The Fish(166124708)#000' 8-max (real money) Seat #2 is the button
Seat 2: ANTEATER555 (151228)
Seat 3: Lilidou14 (52850)
Seat 4: CLEMA (9652)
Seat 5: manggy94 (29592)
Seat 6: See U N T (161514)
Seat 7: cocs64 (38164)
Seat 8: alober76 (27296)
*** ANTE/BLINDS ***
Lilidou14 posts ante 500
CLEMA posts ante 500
ANTEATER555 posts ante 500
manggy94 posts ante 500
See U N T posts ante 500
cocs64 posts ante 500
alober76 posts ante 500
Lilidou14 posts small blind 2000
CLEMA posts big blind 4000
Dealt to manggy94 [Td 2d]
*** PRE-FLOP *** 
manggy94 folds
See U N T folds
cocs64 folds
alober76 folds
ANTEATER555 raises 146728 to 150728 and is all-in
Lilidou14 folds
CLEMA calls 5152 and is all-in
*** FLOP *** [7s Ad Qh]
*** TURN *** [7s Ad Qh][5d]
*** RIVER *** [7s Ad Qh 5d][Tc]
*** SHOW DOWN ***
CLEMA shows [Ts Kh] (One pair : Tens)
ANTEATER555 shows [4d Qc] (One pair : Queens)
ANTEATER555 collected 165380 from pot
*** SUMMARY ***
Total pot 165380 | No rake
Board: [7s Ad Qh 5d Tc]
Seat 2: ANTEATER555 (button) showed [4d Qc] and won 165380 with One pair : Queens
Seat 4: CLEMA (big blind) showed [Ts Kh] and lost with One pair : Tens


Winamax Poker - Tournament "Kill The Fish" buyIn: 9€ + 1€ level: 17 - HandId: #713500187917549569-114-1471374252 - Holdem no limit (500/2000/4000) - 2016/08/16 19:04:12 UTC
Table: 'Kill The Fish(166124708)#000' 8-max (real money) Seat #3 is the button
Seat 2: ANTEATER555 (165380)
Seat 3: Lilidou14 (50350)
Seat 5: manggy94 (29092)
Seat 6: See U N T (161014)
Seat 7: cocs64 (37664)
Seat 8: alober76 (26796)
*** ANTE/BLINDS ***
manggy94 posts ante 500
ANTEATER555 posts ante 500
Lilidou14 posts ante 500
See U N T posts ante 500
cocs64 posts ante 500
alober76 posts ante 500
manggy94 posts big blind 4000
Dealt to manggy94 [8h Th]
*** PRE-FLOP *** 
See U N T raises 4400 to 8400
cocs64 folds
alober76 raises 17896 to 26296 and is all-in
ANTEATER555 folds
Lilidou14 folds
manggy94 folds
See U N T calls 17896
*** FLOP *** [Ks 2s 5h]
*** TURN *** [Ks 2s 5h][6s]
*** RIVER *** [Ks 2s 5h 6s][Jd]
*** SHOW DOWN ***
alober76 shows [8c 8d] (One pair : 8)
See U N T shows [Kh Tc] (One pair : Kings)
See U N T collected 59592 from pot
*** SUMMARY ***
Total pot 59592 | No rake
Board: [Ks 2s 5h 6s Jd]
Seat 6: See U N T showed [Kh Tc] and won 59592 with One pair : Kings
Seat 8: alober76 showed [8c 8d] and lost with One pair : 8


Winamax Poker - Tournament "Kill The Fish" buyIn: 9€ + 1€ level: 17 - HandId: #713500187917549569-115-1471374297 - Holdem no limit (500/2000/4000) - 2016/08/16 19:04:57 UTC
Table: 'Kill The Fish(166124708)#000' 8-max (real money) Seat #4 is the button
Seat 2: ANTEATER555 (164880)
Seat 3: Lilidou14 (49850)
Seat 5: manggy94 (24592)
Seat 6: See U N T (193810)
Seat 7: cocs64 (37164)
*** ANTE/BLINDS ***
manggy94 posts ante 500
See U N T posts ante 500
ANTEATER555 posts ante 500
Lilidou14 posts ante 500
cocs64 posts ante 500
manggy94 posts small blind 2000
See U N T posts big blind 4000
Dealt to manggy94 [Tc 2s]
*** PRE-FLOP *** 
cocs64 folds
ANTEATER555 raises 5640 to 9640
Lilidou14 folds
manggy94 folds
See U N T folds
ANTEATER555 collected 18140 from pot
*** SUMMARY ***
Total pot 18140 | No rake
Seat 2: ANTEATER555 won 18140


Winamax Poker - Tournament "Kill The Fish" buyIn: 9€ + 1€ level: 17 - HandId: #713500187917549569-116-1471374320 - Holdem no limit (500/2000/4000) - 2016/08/16 19:05:20 UTC
Table: 'Kill The Fish(166124708)#000' 8-max (real money) Seat #5 is the button
Seat 2: ANTEATER555 (172880)
Seat 3: Lilidou14 (49350)
Seat 4: asky64 (43858)
Seat 5: manggy94 (22092)
Seat 6: See U N T (189310)
Seat 7: cocs64 (36664)
*** ANTE/BLINDS ***
See U N T posts ante 500
cocs64 posts ante 500
ANTEATER555 posts ante 500
Lilidou14 posts ante 500
asky64 posts ante 500
manggy94 posts ante 500
See U N T posts small blind 2000
cocs64 posts big blind 4000
Dealt to manggy94 [4s 3h]
*** PRE-FLOP *** 
ANTEATER555 folds
Lilidou14 calls 4000
asky64 raises 16000 to 20000
manggy94 folds
See U N T folds
cocs64 folds
Lilidou14 folds
asky64 collected 33000 from pot
*** SUMMARY ***
Total pot 33000 | No rake
Seat 4: asky64 won 33000


Winamax Poker - Tournament "Kill The Fish" buyIn: 9€ + 1€ level: 17 - HandId: #713500187917549569-117-1471374349 - Holdem no limit (500/2000/4000) - 2016/08/16 19:05:49 UTC
Table: 'Kill The Fish(166124708)#000' 8-max (real money) Seat #6 is the button
Seat 1: draft-vipCOM (54914)
Seat 2: ANTEATER555 (172380)
Seat 3: Lilidou14 (44850)
Seat 4: asky64 (56358)
Seat 5: manggy94 (21592)
Seat 6: See U N T (186810)
Seat 7: cocs64 (32164)
Seat 8: DIEU32800 (103797)
*** ANTE/BLINDS ***
cocs64 posts ante 500
DIEU32800 posts ante 500
draft-vipCOM posts ante 500
ANTEATER555 posts ante 500
Lilidou14 posts ante 500
asky64 posts ante 500
manggy94 posts ante 500
See U N T posts ante 500
cocs64 posts small blind 2000
DIEU32800 posts big blind 4000
Dealt to manggy94 [4s Ts]
*** PRE-FLOP *** 
draft-vipCOM raises 4000 to 8000
ANTEATER555 folds
Lilidou14 folds
asky64 folds
manggy94 folds
See U N T folds
cocs64 folds
DIEU32800 calls 4000
*** FLOP *** [6c Jh Jc]
DIEU32800 checks
draft-vipCOM checks
*** TURN *** [6c Jh Jc][Kc]
DIEU32800 checks
draft-vipCOM checks
*** RIVER *** [6c Jh Jc Kc][2h]
DIEU32800 checks
draft-vipCOM bets 12000
DIEU32800 folds
draft-vipCOM collected 34000 from pot
*** SUMMARY ***
Total pot 34000 | No rake
Board: [6c Jh Jc Kc 2h]
Seat 1: draft-vipCOM won 34000


Winamax Poker - Tournament "Kill The Fish" buyIn: 9€ + 1€ level: 18 - HandId: #713500187917549569-118-1471374433 - Holdem no limit (620/2500/5000) - 2016/08/16 19:07:13 UTC
Table: 'Kill The Fish(166124708)#000' 8-max (real money) Seat #7 is the button
Seat 1: draft-vipCOM (68414)
Seat 2: ANTEATER555 (171880)
Seat 3: Lilidou14 (44350)
Seat 4: asky64 (55858)
Seat 5: manggy94 (21092)
Seat 6: See U N T (186310)
Seat 7: cocs64 (29664)
Seat 8: DIEU32800 (95297)
*** ANTE/BLINDS ***
DIEU32800 posts ante 620
draft-vipCOM posts ante 620
ANTEATER555 posts ante 620
Lilidou14 posts ante 620
asky64 posts ante 620
manggy94 posts ante 620
See U N T posts ante 620
cocs64 posts ante 620
DIEU32800 posts small blind 2500
draft-vipCOM posts big blind 5000
Dealt to manggy94 [3s 5h]
*** PRE-FLOP *** 
ANTEATER555 folds
Lilidou14 folds
asky64 raises 5000 to 10000
manggy94 folds
See U N T folds
cocs64 folds
DIEU32800 folds
draft-vipCOM folds
asky64 collected 22460 from pot
*** SUMMARY ***
Total pot 22460 | No rake
Seat 4: asky64 won 22460


Winamax Poker - Tournament "Kill The Fish" buyIn: 9€ + 1€ level: 18 - HandId: #713500187917549569-119-1471374463 - Holdem no limit (620/2500/5000) - 2016/08/16 19:07:43 UTC
Table: 'Kill The Fish(166124708)#000' 8-max (real money) Seat #8 is the button
Seat 1: draft-vipCOM (62794)
Seat 2: ANTEATER555 (171260)
Seat 3: Lilidou14 (43730)
Seat 4: asky64 (67698)
Seat 5: manggy94 (20472)
Seat 6: See U N T (185690)
Seat 7: cocs64 (29044)
Seat 8: DIEU32800 (92177)
*** ANTE/BLINDS ***
draft-vipCOM posts ante 620
ANTEATER555 posts ante 620
Lilidou14 posts ante 620
asky64 posts ante 620
manggy94 posts ante 620
See U N T posts ante 620
cocs64 posts ante 620
DIEU32800 posts ante 620
draft-vipCOM posts small blind 2500
ANTEATER555 posts big blind 5000
Dealt to manggy94 [5c 2c]
*** PRE-FLOP *** 
Lilidou14 raises 38110 to 43110 and is all-in
asky64 folds
manggy94 folds
See U N T raises 141960 to 185070 and is all-in
cocs64 folds
DIEU32800 folds
draft-vipCOM folds
ANTEATER555 folds
*** FLOP *** [8c 3h 7c]
*** TURN *** [8c 3h 7c][8s]
*** RIVER *** [8c 3h 7c 8s][6d]
*** SHOW DOWN ***
Lilidou14 shows [Kd Ts] (One pair : 8)
See U N T shows [Ks As] (One pair : 8)
See U N T collected 240640 from pot
*** SUMMARY ***
Total pot 240640 | No rake
Board: [8c 3h 7c 8s 6d]
Seat 3: Lilidou14 showed [Kd Ts] and lost with One pair : 8
Seat 6: See U N T showed [Ks As] and won 240640 with One pair : 8


Winamax Poker - Tournament "Kill The Fish" buyIn: 9€ + 1€ level: 18 - HandId: #713500187917549569-120-1471374537 - Holdem no limit (620/2500/5000) - 2016/08/16 19:08:57 UTC
Table: 'Kill The Fish(166124708)#000' 8-max (real money) Seat #1 is the button
Seat 1: draft-vipCOM (59674)
Seat 2: ANTEATER555 (165640)
Seat 4: asky64 (67078)
Seat 5: manggy94 (19852)
Seat 6: See U N T (240640)
Seat 7: cocs64 (28424)
Seat 8: DIEU32800 (91557)
*** ANTE/BLINDS ***
ANTEATER555 posts ante 620
asky64 posts ante 620
draft-vipCOM posts ante 620
manggy94 posts ante 620
See U N T posts ante 620
cocs64 posts ante 620
DIEU32800 posts ante 620
ANTEATER555 posts small blind 2500
asky64 posts big blind 5000
Dealt to manggy94 [Jd 3s]
*** PRE-FLOP *** 
manggy94 folds
See U N T folds
cocs64 folds
DIEU32800 raises 5000 to 10000
draft-vipCOM folds
ANTEATER555 folds
asky64 folds
DIEU32800 collected 21840 from pot
*** SUMMARY ***
Total pot 21840 | No rake
Seat 8: DIEU32800 won 21840


Winamax Poker - Tournament "Kill The Fish" buyIn: 9€ + 1€ level: 18 - HandId: #713500187917549569-121-1471374552 - Holdem no limit (620/2500/5000) - 2016/08/16 19:09:12 UTC
Table: 'Kill The Fish(166124708)#000' 8-max (real money) Seat #2 is the button
Seat 1: draft-vipCOM (59054)
Seat 2: ANTEATER555 (162520)
Seat 4: asky64 (61458)
Seat 5: manggy94 (19232)
Seat 6: See U N T (240020)
Seat 7: cocs64 (27804)
Seat 8: DIEU32800 (102777)
*** ANTE/BLINDS ***
asky64 posts ante 620
manggy94 posts ante 620
draft-vipCOM posts ante 620
ANTEATER555 posts ante 620
See U N T posts ante 620
cocs64 posts ante 620
DIEU32800 posts ante 620
asky64 posts small blind 2500
manggy94 posts big blind 5000
Dealt to manggy94 [Qs 8h]
*** PRE-FLOP *** 
See U N T folds
cocs64 raises 22184 to 27184 and is all-in
DIEU32800 folds
draft-vipCOM folds
ANTEATER555 folds
asky64 folds
manggy94 folds
cocs64 collected 39024 from pot
*** SUMMARY ***
Total pot 39024 | No rake
Seat 7: cocs64 won 39024


Winamax Poker - Tournament "Kill The Fish" buyIn: 9€ + 1€ level: 18 - HandId: #713500187917549569-122-1471374570 - Holdem no limit (620/2500/5000) - 2016/08/16 19:09:30 UTC
Table: 'Kill The Fish(166124708)#000' 8-max (real money) Seat #4 is the button
Seat 1: draft-vipCOM (58434)
Seat 2: ANTEATER555 (161900)
Seat 4: asky64 (58338)
Seat 5: manggy94 (13612)
Seat 6: See U N T (239400)
Seat 7: cocs64 (39024)
Seat 8: DIEU32800 (102157)
*** ANTE/BLINDS ***
manggy94 posts ante 620
See U N T posts ante 620
draft-vipCOM posts ante 620
ANTEATER555 posts ante 620
asky64 posts ante 620
cocs64 posts ante 620
DIEU32800 posts ante 620
manggy94 posts small blind 2500
See U N T posts big blind 5000
Dealt to manggy94 [2d Qh]
*** PRE-FLOP *** 
cocs64 folds
DIEU32800 folds
draft-vipCOM folds
ANTEATER555 raises 5600 to 10600
asky64 folds
manggy94 folds
See U N T calls 5600
*** FLOP *** [3h 8h Qs]
See U N T checks
ANTEATER555 bets 11777
See U N T folds
ANTEATER555 collected 39817 from pot
*** SUMMARY ***
Total pot 39817 | No rake
Board: [3h 8h Qs]
Seat 2: ANTEATER555 won 39817


Winamax Poker - Tournament "Kill The Fish" buyIn: 9€ + 1€ level: 18 - HandId: #713500187917549569-123-1471374592 - Holdem no limit (620/2500/5000) - 2016/08/16 19:09:52 UTC
Table: 'Kill The Fish(166124708)#000' 8-max (real money) Seat #5 is the button
Seat 1: draft-vipCOM (57814)
Seat 2: ANTEATER555 (178720)
Seat 4: asky64 (57718)
Seat 5: manggy94 (10492)
Seat 6: See U N T (228180)
Seat 7: cocs64 (38404)
Seat 8: DIEU32800 (101537)
*** ANTE/BLINDS ***
See U N T posts ante 620
cocs64 posts ante 620
draft-vipCOM posts ante 620
ANTEATER555 posts ante 620
asky64 posts ante 620
manggy94 posts ante 620
DIEU32800 posts ante 620
See U N T posts small blind 2500
cocs64 posts big blind 5000
Dealt to manggy94 [7c 5h]
*** PRE-FLOP *** 
DIEU32800 folds
draft-vipCOM raises 52194 to 57194 and is all-in
ANTEATER555 folds
asky64 folds
manggy94 folds
See U N T folds
cocs64 folds
draft-vipCOM collected 69034 from pot
*** SUMMARY ***
Total pot 69034 | No rake
Seat 1: draft-vipCOM won 69034


Winamax Poker - Tournament "Kill The Fish" buyIn: 9€ + 1€ level: 18 - HandId: #713500187917549569-124-1471374620 - Holdem no limit (620/2500/5000) - 2016/08/16 19:10:20 UTC
Table: 'Kill The Fish(166124708)#000' 8-max (real money) Seat #6 is the button
Seat 1: draft-vipCOM (69034)
Seat 2: ANTEATER555 (178100)
Seat 4: asky64 (57098)
Seat 5: manggy94 (9872)
Seat 6: See U N T (225060)
Seat 7: cocs64 (32784)
Seat 8: DIEU32800 (100917)
*** ANTE/BLINDS ***
cocs64 posts ante 620
DIEU32800 posts ante 620
draft-vipCOM posts ante 620
ANTEATER555 posts ante 620
asky64 posts ante 620
manggy94 posts ante 620
See U N T posts ante 620
cocs64 posts small blind 2500
DIEU32800 posts big blind 5000
Dealt to manggy94 [7s 2h]
*** PRE-FLOP *** 
draft-vipCOM raises 63414 to 68414 and is all-in
ANTEATER555 folds
asky64 folds
manggy94 folds
See U N T folds
cocs64 folds
DIEU32800 folds
draft-vipCOM collected 80254 from pot
*** SUMMARY ***
Total pot 80254 | No rake
Seat 1: draft-vipCOM won 80254


Winamax Poker - Tournament "Kill The Fish" buyIn: 9€ + 1€ level: 18 - HandId: #713500187917549569-125-1471374647 - Holdem no limit (620/2500/5000) - 2016/08/16 19:10:47 UTC
Table: 'Kill The Fish(166124708)#000' 8-max (real money) Seat #7 is the button
Seat 1: draft-vipCOM (80254)
Seat 2: ANTEATER555 (177480)
Seat 4: asky64 (56478)
Seat 5: manggy94 (9252)
Seat 6: See U N T (224440)
Seat 7: cocs64 (29664)
Seat 8: DIEU32800 (95297)
*** ANTE/BLINDS ***
DIEU32800 posts ante 620
draft-vipCOM posts ante 620
ANTEATER555 posts ante 620
asky64 posts ante 620
manggy94 posts ante 620
See U N T posts ante 620
cocs64 posts ante 620
DIEU32800 posts small blind 2500
draft-vipCOM posts big blind 5000
Dealt to manggy94 [5d Jc]
*** PRE-FLOP *** 
ANTEATER555 folds
asky64 folds
manggy94 folds
See U N T raises 5500 to 10500
cocs64 folds
DIEU32800 folds
draft-vipCOM calls 5500
*** FLOP *** [6d Ac 6h]
draft-vipCOM checks
See U N T bets 13085
draft-vipCOM folds
See U N T collected 40925 from pot
*** SUMMARY ***
Total pot 40925 | No rake
Board: [6d Ac 6h]
Seat 6: See U N T won 40925


Winamax Poker - Tournament "Kill The Fish" buyIn: 9€ + 1€ level: 18 - HandId: #713500187917549569-126-1471374735 - Holdem no limit (620/2500/5000) - 2016/08/16 19:12:15 UTC
Table: 'Kill The Fish(166124708)#000' 8-max (real money) Seat #8 is the button
Seat 1: draft-vipCOM (69134)
Seat 2: ANTEATER555 (176860)
Seat 4: asky64 (55858)
Seat 5: manggy94 (8632)
Seat 6: See U N T (241160)
Seat 7: cocs64 (29044)
Seat 8: DIEU32800 (92177)
*** ANTE/BLINDS ***
draft-vipCOM posts ante 620
ANTEATER555 posts ante 620
asky64 posts ante 620
manggy94 posts ante 620
See U N T posts ante 620
cocs64 posts ante 620
DIEU32800 posts ante 620
draft-vipCOM posts small blind 2500
ANTEATER555 posts big blind 5000
Dealt to manggy94 [9c Qh]
*** PRE-FLOP *** 
asky64 folds
manggy94 folds
See U N T folds
cocs64 folds
DIEU32800 raises 5000 to 10000
draft-vipCOM folds
ANTEATER555 calls 5000
*** FLOP *** [Js 4c 6s]
ANTEATER555 checks
DIEU32800 bets 17893
ANTEATER555 folds
DIEU32800 collected 44733 from pot
*** SUMMARY ***
Total pot 44733 | No rake
Board: [Js 4c 6s]
Seat 8: DIEU32800 (button) won 44733


Winamax Poker - Tournament "Kill The Fish" buyIn: 9€ + 1€ level: 19 - HandId: #713500187917549569-127-1471374813 - Holdem no limit (820/3000/6000) - 2016/08/16 19:13:33 UTC
Table: 'Kill The Fish(166124708)#000' 8-max (real money) Seat #1 is the button
Seat 1: draft-vipCOM (66014)
Seat 2: ANTEATER555 (166240)
Seat 4: asky64 (55238)
Seat 5: manggy94 (8012)
Seat 6: See U N T (240540)
Seat 7: cocs64 (28424)
Seat 8: DIEU32800 (108397)
*** ANTE/BLINDS ***
ANTEATER555 posts ante 820
asky64 posts ante 820
draft-vipCOM posts ante 820
manggy94 posts ante 820
See U N T posts ante 820
cocs64 posts ante 820
DIEU32800 posts ante 820
ANTEATER555 posts small blind 3000
asky64 posts big blind 6000
Dealt to manggy94 [9d Qc]
*** PRE-FLOP *** 
manggy94 folds
See U N T folds
cocs64 folds
DIEU32800 folds
draft-vipCOM folds
ANTEATER555 raises 159420 to 165420 and is all-in
asky64 folds
ANTEATER555 collected 177160 from pot
*** SUMMARY ***
Total pot 177160 | No rake
Seat 2: ANTEATER555 (small blind) won 177160


Winamax Poker - Tournament "Kill The Fish" buyIn: 9€ + 1€ level: 19 - HandId: #713500187917549569-128-1471374838 - Holdem no limit (820/3000/6000) - 2016/08/16 19:13:58 UTC
Table: 'Kill The Fish(166124708)#000' 8-max (real money) Seat #2 is the button
Seat 1: draft-vipCOM (65194)
Seat 2: ANTEATER555 (177160)
Seat 4: asky64 (48418)
Seat 5: manggy94 (7192)
Seat 6: See U N T (239720)
Seat 7: cocs64 (27604)
Seat 8: DIEU32800 (107577)
*** ANTE/BLINDS ***
asky64 posts ante 820
manggy94 posts ante 820
draft-vipCOM posts ante 820
ANTEATER555 posts ante 820
See U N T posts ante 820
cocs64 posts ante 820
DIEU32800 posts ante 820
asky64 posts small blind 3000
manggy94 posts big blind 6000
Dealt to manggy94 [Ah 7d]
*** PRE-FLOP *** 
See U N T folds
cocs64 folds
DIEU32800 folds
draft-vipCOM raises 58374 to 64374 and is all-in
ANTEATER555 folds
asky64 folds
manggy94 calls 372 and is all-in
*** FLOP *** [Qs 6h 5c]
*** TURN *** [Qs 6h 5c][2h]
*** RIVER *** [Qs 6h 5c 2h][2d]
*** SHOW DOWN ***
manggy94 shows [Ah 7d] (One pair : 2)
draft-vipCOM shows [Qd Js] (Two pairs : Queens and 2)
draft-vipCOM collected 79486 from pot
*** SUMMARY ***
Total pot 79486 | No rake
Board: [Qs 6h 5c 2h 2d]
Seat 1: draft-vipCOM showed [Qd Js] and won 79486 with Two pairs : Queens and 2
Seat 5: manggy94 (big blind) showed [Ah 7d] and lost with One pair : 2


