Winamax Poker - Tournament "Qualif. Ticket 10€" buyIn: 1.80€ + 0.20€ level: 5 - HandId: #853654187785846788-9-1497872074 - Holdem no limit (10/40/80) - 2017/06/19 11:34:34 UTC
Table: 'Qualif. Ticket 10€(198756854)#003' 6-max (real money) Seat #4 is the button
Seat 1: manggy94 (3000)
Seat 2: byckers (3120)
Seat 3: VivlesBrelan (3171)
Seat 4: Mona.Lisa (1818)
Seat 5: Peter pAAn (2926)
Seat 6: MAYOUSSS (3153)
*** ANTE/BLINDS ***
Peter pAAn posts ante 10
MAYOUSSS posts ante 10
manggy94 posts ante 10
byckers posts ante 10
VivlesBrelan posts ante 10
Mona.Lisa posts ante 10
Peter pAAn posts small blind 40
MAYOUSSS posts big blind 80
Dealt to manggy94 [Ad 5h]
*** PRE-FLOP *** 
manggy94 raises 80 to 160
byckers raises 2950 to 3110 and is all-in
VivlesBrelan folds
Mona.Lisa folds
Peter pAAn calls 2876 and is all-in
MAYOUSSS folds
manggy94 folds
*** FLOP *** [3d 7s 2d]
*** TURN *** [3d 7s 2d][3c]
*** RIVER *** [3d 7s 2d 3c][Ts]
*** SHOW DOWN ***
byckers shows [Qc As] (One pair : 3)
Peter pAAn shows [Js Jc] (Two pairs : Jacks and 3)
Peter pAAn collected 6132 from main pot
byckers collected 194 from side pot 1
*** SUMMARY ***
Total pot 6326 | No rake
Board: [3d 7s 2d 3c Ts]
Seat 2: byckers showed [Qc As] and won 194 with One pair : 3
Seat 5: Peter pAAn (small blind) showed [Js Jc] and won 6132 with Two pairs : Jacks and 3


Winamax Poker - Tournament "Qualif. Ticket 10€" buyIn: 1.80€ + 0.20€ level: 5 - HandId: #853654187785846788-10-1497872159 - Holdem no limit (10/40/80) - 2017/06/19 11:35:59 UTC
Table: 'Qualif. Ticket 10€(198756854)#003' 6-max (real money) Seat #5 is the button
Seat 1: manggy94 (2830)
Seat 2: byckers (194)
Seat 3: VivlesBrelan (3161)
Seat 4: Mona.Lisa (1808)
Seat 5: Peter pAAn (6132)
Seat 6: MAYOUSSS (3063)
*** ANTE/BLINDS ***
MAYOUSSS posts ante 10
manggy94 posts ante 10
byckers posts ante 10
VivlesBrelan posts ante 10
Mona.Lisa posts ante 10
Peter pAAn posts ante 10
MAYOUSSS posts small blind 40
manggy94 posts big blind 80
Dealt to manggy94 [Kh 6s]
*** PRE-FLOP *** 
byckers folds
VivlesBrelan folds
Mona.Lisa folds
Peter pAAn folds
MAYOUSSS folds
manggy94 collected 180 from pot
*** SUMMARY ***
Total pot 180 | No rake
Seat 1: manggy94 (big blind) won 180


Winamax Poker - Tournament "Qualif. Ticket 10€" buyIn: 1.80€ + 0.20€ level: 5 - HandId: #853654187785846788-11-1497872184 - Holdem no limit (10/40/80) - 2017/06/19 11:36:24 UTC
Table: 'Qualif. Ticket 10€(198756854)#003' 6-max (real money) Seat #6 is the button
Seat 1: manggy94 (2920)
Seat 2: byckers (184)
Seat 3: VivlesBrelan (3151)
Seat 4: Mona.Lisa (1798)
Seat 5: Peter pAAn (6122)
Seat 6: MAYOUSSS (3013)
*** ANTE/BLINDS ***
manggy94 posts ante 10
byckers posts ante 10
VivlesBrelan posts ante 10
Mona.Lisa posts ante 10
Peter pAAn posts ante 10
MAYOUSSS posts ante 10
manggy94 posts small blind 40
byckers posts big blind 80
Dealt to manggy94 [Tc 8s]
*** PRE-FLOP *** 
VivlesBrelan folds
Mona.Lisa folds
Peter pAAn folds
MAYOUSSS folds
manggy94 folds
byckers collected 180 from pot
*** SUMMARY ***
Total pot 180 | No rake
Seat 2: byckers (big blind) won 180


Winamax Poker - Tournament "Qualif. Ticket 10€" buyIn: 1.80€ + 0.20€ level: 5 - HandId: #853654187785846788-12-1497872251 - Holdem no limit (10/40/80) - 2017/06/19 11:37:31 UTC
Table: 'Qualif. Ticket 10€(198756854)#003' 6-max (real money) Seat #1 is the button
Seat 1: manggy94 (2870)
Seat 2: byckers (274)
Seat 3: VivlesBrelan (3141)
Seat 4: Mona.Lisa (1788)
Seat 5: Peter pAAn (6112)
Seat 6: MAYOUSSS (3003)
*** ANTE/BLINDS ***
byckers posts ante 10
VivlesBrelan posts ante 10
manggy94 posts ante 10
Mona.Lisa posts ante 10
Peter pAAn posts ante 10
MAYOUSSS posts ante 10
byckers posts small blind 40
VivlesBrelan posts big blind 80
Dealt to manggy94 [9c 8s]
*** PRE-FLOP *** 
Mona.Lisa folds
Peter pAAn folds
MAYOUSSS folds
manggy94 calls 80
byckers raises 184 to 264 and is all-in
VivlesBrelan folds
manggy94 calls 184
*** FLOP *** [Kc Qc Tc]
*** TURN *** [Kc Qc Tc][5c]
*** RIVER *** [Kc Qc Tc 5c][Td]
*** SHOW DOWN ***
byckers shows [7d 9h] (One pair : Tens)
manggy94 shows [9c 8s] (Flush King high)
manggy94 collected 668 from pot
*** SUMMARY ***
Total pot 668 | No rake
Board: [Kc Qc Tc 5c Td]
Seat 1: manggy94 (button) showed [9c 8s] and won 668 with Flush King high
Seat 2: byckers (small blind) showed [7d 9h] and lost with One pair : Tens


Winamax Poker - Tournament "Qualif. Ticket 10€" buyIn: 1.80€ + 0.20€ level: 5 - HandId: #853654187785846788-13-1497872298 - Holdem no limit (10/40/80) - 2017/06/19 11:38:18 UTC
Table: 'Qualif. Ticket 10€(198756854)#003' 6-max (real money) Seat #2 is the button
Seat 1: manggy94 (3264)
Seat 3: VivlesBrelan (3051)
Seat 4: Mona.Lisa (1778)
Seat 5: Peter pAAn (6102)
Seat 6: MAYOUSSS (2993)
*** ANTE/BLINDS ***
VivlesBrelan posts ante 10
Mona.Lisa posts ante 10
manggy94 posts ante 10
Peter pAAn posts ante 10
MAYOUSSS posts ante 10
VivlesBrelan posts small blind 40
Mona.Lisa posts big blind 80
Dealt to manggy94 [6c 3d]
*** PRE-FLOP *** 
Peter pAAn folds
MAYOUSSS raises 103 to 183
manggy94 folds
VivlesBrelan folds
Mona.Lisa folds
MAYOUSSS collected 353 from pot
*** SUMMARY ***
Total pot 353 | No rake
Seat 6: MAYOUSSS won 353


Winamax Poker - Tournament "Qualif. Ticket 10€" buyIn: 1.80€ + 0.20€ level: 5 - HandId: #853654187785846788-14-1497872336 - Holdem no limit (10/40/80) - 2017/06/19 11:38:56 UTC
Table: 'Qualif. Ticket 10€(198756854)#003' 6-max (real money) Seat #3 is the button
Seat 1: manggy94 (3254)
Seat 3: VivlesBrelan (3001)
Seat 4: Mona.Lisa (1688)
Seat 5: Peter pAAn (6092)
Seat 6: MAYOUSSS (3153)
*** ANTE/BLINDS ***
Mona.Lisa posts ante 10
Peter pAAn posts ante 10
manggy94 posts ante 10
VivlesBrelan posts ante 10
MAYOUSSS posts ante 10
Mona.Lisa posts small blind 40
Peter pAAn posts big blind 80
Dealt to manggy94 [Qs Jd]
*** PRE-FLOP *** 
MAYOUSSS folds
manggy94 raises 80 to 160
VivlesBrelan folds
Mona.Lisa folds
Peter pAAn calls 80
*** FLOP *** [7d 5d 9c]
Peter pAAn checks
manggy94 bets 205
Peter pAAn calls 205
*** TURN *** [7d 5d 9c][2d]
Peter pAAn checks
manggy94 bets 820
Peter pAAn folds
manggy94 collected 1640 from pot
*** SUMMARY ***
Total pot 1640 | No rake
Board: [7d 5d 9c 2d]
Seat 1: manggy94 won 1640


Winamax Poker - Tournament "Qualif. Ticket 10€" buyIn: 1.80€ + 0.20€ level: 6 - HandId: #853654187785846788-15-1497872414 - Holdem no limit (12/50/100) - 2017/06/19 11:40:14 UTC
Table: 'Qualif. Ticket 10€(198756854)#003' 6-max (real money) Seat #4 is the button
Seat 1: manggy94 (3699)
Seat 3: VivlesBrelan (2991)
Seat 4: Mona.Lisa (1638)
Seat 5: Peter pAAn (5717)
Seat 6: MAYOUSSS (3143)
*** ANTE/BLINDS ***
Peter pAAn posts ante 12
MAYOUSSS posts ante 12
manggy94 posts ante 12
VivlesBrelan posts ante 12
Mona.Lisa posts ante 12
Peter pAAn posts small blind 50
MAYOUSSS posts big blind 100
Dealt to manggy94 [7d Jh]
*** PRE-FLOP *** 
manggy94 folds
VivlesBrelan folds
Mona.Lisa folds
Peter pAAn raises 130 to 230
MAYOUSSS calls 130
*** FLOP *** [7h Kc Jd]
Peter pAAn checks
MAYOUSSS bets 173
Peter pAAn calls 173
*** TURN *** [7h Kc Jd][4d]
Peter pAAn checks
MAYOUSSS bets 289
Peter pAAn folds
MAYOUSSS collected 1155 from pot
*** SUMMARY ***
Total pot 1155 | No rake
Board: [7h Kc Jd 4d]
Seat 6: MAYOUSSS (big blind) won 1155


Winamax Poker - Tournament "Qualif. Ticket 10€" buyIn: 1.80€ + 0.20€ level: 6 - HandId: #853654187785846788-16-1497872481 - Holdem no limit (12/50/100) - 2017/06/19 11:41:21 UTC
Table: 'Qualif. Ticket 10€(198756854)#003' 6-max (real money) Seat #5 is the button
Seat 1: manggy94 (3687)
Seat 3: VivlesBrelan (2979)
Seat 4: Mona.Lisa (1626)
Seat 5: Peter pAAn (5302)
Seat 6: MAYOUSSS (3594)
*** ANTE/BLINDS ***
MAYOUSSS posts ante 12
manggy94 posts ante 12
VivlesBrelan posts ante 12
Mona.Lisa posts ante 12
Peter pAAn posts ante 12
MAYOUSSS posts small blind 50
manggy94 posts big blind 100
Dealt to manggy94 [8c Tc]
*** PRE-FLOP *** 
VivlesBrelan folds
Mona.Lisa folds
Peter pAAn folds
MAYOUSSS folds
manggy94 collected 210 from pot
*** SUMMARY ***
Total pot 210 | No rake
Seat 1: manggy94 (big blind) won 210


Winamax Poker - Tournament "Qualif. Ticket 10€" buyIn: 1.80€ + 0.20€ level: 6 - HandId: #853654187785846788-17-1497872494 - Holdem no limit (12/50/100) - 2017/06/19 11:41:34 UTC
Table: 'Qualif. Ticket 10€(198756854)#003' 6-max (real money) Seat #6 is the button
Seat 1: manggy94 (3785)
Seat 3: VivlesBrelan (2967)
Seat 4: Mona.Lisa (1614)
Seat 5: Peter pAAn (5290)
Seat 6: MAYOUSSS (3532)
*** ANTE/BLINDS ***
manggy94 posts ante 12
VivlesBrelan posts ante 12
Mona.Lisa posts ante 12
Peter pAAn posts ante 12
MAYOUSSS posts ante 12
manggy94 posts small blind 50
VivlesBrelan posts big blind 100
Dealt to manggy94 [7c 5s]
*** PRE-FLOP *** 
Mona.Lisa folds
Peter pAAn folds
MAYOUSSS folds
manggy94 raises 100 to 200
VivlesBrelan folds
manggy94 collected 360 from pot
*** SUMMARY ***
Total pot 360 | No rake
Seat 1: manggy94 (small blind) won 360


Winamax Poker - Tournament "Qualif. Ticket 10€" buyIn: 1.80€ + 0.20€ level: 6 - HandId: #853654187785846788-18-1497872524 - Holdem no limit (12/50/100) - 2017/06/19 11:42:04 UTC
Table: 'Qualif. Ticket 10€(198756854)#003' 6-max (real money) Seat #1 is the button
Seat 1: manggy94 (3933)
Seat 3: VivlesBrelan (2855)
Seat 4: Mona.Lisa (1602)
Seat 5: Peter pAAn (5278)
Seat 6: MAYOUSSS (3520)
*** ANTE/BLINDS ***
VivlesBrelan posts ante 12
Mona.Lisa posts ante 12
manggy94 posts ante 12
Peter pAAn posts ante 12
MAYOUSSS posts ante 12
VivlesBrelan posts small blind 50
Mona.Lisa posts big blind 100
Dealt to manggy94 [9s Tc]
*** PRE-FLOP *** 
Peter pAAn raises 130 to 230
MAYOUSSS folds
manggy94 folds
VivlesBrelan folds
Mona.Lisa folds
Peter pAAn collected 440 from pot
*** SUMMARY ***
Total pot 440 | No rake
Seat 5: Peter pAAn won 440


Winamax Poker - Tournament "Qualif. Ticket 10€" buyIn: 1.80€ + 0.20€ level: 6 - HandId: #853654187785846788-19-1497872542 - Holdem no limit (12/50/100) - 2017/06/19 11:42:22 UTC
Table: 'Qualif. Ticket 10€(198756854)#003' 6-max (real money) Seat #3 is the button
Seat 1: manggy94 (3921)
Seat 3: VivlesBrelan (2793)
Seat 4: Mona.Lisa (1490)
Seat 5: Peter pAAn (5476)
Seat 6: MAYOUSSS (3508)
*** ANTE/BLINDS ***
Mona.Lisa posts ante 12
Peter pAAn posts ante 12
manggy94 posts ante 12
VivlesBrelan posts ante 12
MAYOUSSS posts ante 12
Mona.Lisa posts small blind 50
Peter pAAn posts big blind 100
Dealt to manggy94 [6h 3d]
*** PRE-FLOP *** 
MAYOUSSS folds
manggy94 folds
VivlesBrelan folds
Mona.Lisa folds
Peter pAAn collected 210 from pot
*** SUMMARY ***
Total pot 210 | No rake
Seat 5: Peter pAAn (big blind) won 210


Winamax Poker - Tournament "Qualif. Ticket 10€" buyIn: 1.80€ + 0.20€ level: 6 - HandId: #853654187785846788-20-1497872577 - Holdem no limit (12/50/100) - 2017/06/19 11:42:57 UTC
Table: 'Qualif. Ticket 10€(198756854)#003' 6-max (real money) Seat #4 is the button
Seat 1: manggy94 (3909)
Seat 3: VivlesBrelan (2781)
Seat 4: Mona.Lisa (1428)
Seat 5: Peter pAAn (5574)
Seat 6: MAYOUSSS (3496)
*** ANTE/BLINDS ***
Peter pAAn posts ante 12
MAYOUSSS posts ante 12
manggy94 posts ante 12
VivlesBrelan posts ante 12
Mona.Lisa posts ante 12
Peter pAAn posts small blind 50
MAYOUSSS posts big blind 100
Dealt to manggy94 [Qs Ks]
*** PRE-FLOP *** 
manggy94 calls 100
VivlesBrelan folds
Mona.Lisa folds
Peter pAAn folds
MAYOUSSS checks
*** FLOP *** [Kd Kh Qd]
MAYOUSSS checks
manggy94 checks
*** TURN *** [Kd Kh Qd][4s]
MAYOUSSS checks
manggy94 bets 100
MAYOUSSS folds
manggy94 collected 410 from pot
*** SUMMARY ***
Total pot 410 | No rake
Board: [Kd Kh Qd 4s]
Seat 1: manggy94 won 410


Winamax Poker - Tournament "Qualif. Ticket 10€" buyIn: 1.80€ + 0.20€ level: 6 - HandId: #853654187785846788-21-1497872629 - Holdem no limit (12/50/100) - 2017/06/19 11:43:49 UTC
Table: 'Qualif. Ticket 10€(198756854)#003' 6-max (real money) Seat #5 is the button
Seat 1: manggy94 (4107)
Seat 3: VivlesBrelan (2769)
Seat 4: Mona.Lisa (1416)
Seat 5: Peter pAAn (5512)
Seat 6: MAYOUSSS (3384)
*** ANTE/BLINDS ***
MAYOUSSS posts ante 12
manggy94 posts ante 12
VivlesBrelan posts ante 12
Mona.Lisa posts ante 12
Peter pAAn posts ante 12
MAYOUSSS posts small blind 50
manggy94 posts big blind 100
Dealt to manggy94 [6s 9d]
*** PRE-FLOP *** 
VivlesBrelan raises 150 to 250
Mona.Lisa folds
Peter pAAn folds
MAYOUSSS folds
manggy94 folds
VivlesBrelan collected 460 from pot
*** SUMMARY ***
Total pot 460 | No rake
Seat 3: VivlesBrelan won 460


Winamax Poker - Tournament "Qualif. Ticket 10€" buyIn: 1.80€ + 0.20€ level: 6 - HandId: #853654187785846788-22-1497872661 - Holdem no limit (12/50/100) - 2017/06/19 11:44:21 UTC
Table: 'Qualif. Ticket 10€(198756854)#003' 6-max (real money) Seat #6 is the button
Seat 1: manggy94 (3995)
Seat 3: VivlesBrelan (2967)
Seat 4: Mona.Lisa (1404)
Seat 5: Peter pAAn (5500)
Seat 6: MAYOUSSS (3322)
*** ANTE/BLINDS ***
manggy94 posts ante 12
VivlesBrelan posts ante 12
Mona.Lisa posts ante 12
Peter pAAn posts ante 12
MAYOUSSS posts ante 12
manggy94 posts small blind 50
VivlesBrelan posts big blind 100
Dealt to manggy94 [7d 8h]
*** PRE-FLOP *** 
Mona.Lisa folds
Peter pAAn raises 130 to 230
MAYOUSSS raises 270 to 500
manggy94 folds
VivlesBrelan folds
Peter pAAn calls 270
*** FLOP *** [3s Kc Td]
Peter pAAn checks
MAYOUSSS bets 403
Peter pAAn calls 403
*** TURN *** [3s Kc Td][2d]
Peter pAAn checks
MAYOUSSS bets 672
Peter pAAn calls 672
*** RIVER *** [3s Kc Td 2d][9h]
Peter pAAn checks
MAYOUSSS bets 1120
Peter pAAn folds
MAYOUSSS collected 4480 from pot
*** SUMMARY ***
Total pot 4480 | No rake
Board: [3s Kc Td 2d 9h]
Seat 6: MAYOUSSS (button) won 4480


Winamax Poker - Tournament "Qualif. Ticket 10€" buyIn: 1.80€ + 0.20€ level: 7 - HandId: #853654187785846788-23-1497872789 - Holdem no limit (15/60/120) - 2017/06/19 11:46:29 UTC
Table: 'Qualif. Ticket 10€(198756854)#003' 6-max (real money) Seat #1 is the button
Seat 1: manggy94 (3933)
Seat 2: LEurNzeproZe (3000)
Seat 3: VivlesBrelan (2855)
Seat 4: Mona.Lisa (1392)
Seat 5: Peter pAAn (3913)
Seat 6: MAYOUSSS (5095)
*** ANTE/BLINDS ***
VivlesBrelan posts ante 15
Mona.Lisa posts ante 15
manggy94 posts ante 15
Peter pAAn posts ante 15
MAYOUSSS posts ante 15
VivlesBrelan posts small blind 60
Mona.Lisa posts big blind 120
Dealt to manggy94 [Ks 5s]
*** PRE-FLOP *** 
Peter pAAn folds
MAYOUSSS folds
manggy94 calls 120
VivlesBrelan calls 60
Mona.Lisa raises 1257 to 1377 and is all-in
manggy94 folds
VivlesBrelan folds
Mona.Lisa collected 1692 from pot
*** SUMMARY ***
Total pot 1692 | No rake
Seat 4: Mona.Lisa (big blind) won 1692


Winamax Poker - Tournament "Qualif. Ticket 10€" buyIn: 1.80€ + 0.20€ level: 7 - HandId: #853654187785846788-24-1497872829 - Holdem no limit (15/60/120) - 2017/06/19 11:47:09 UTC
Table: 'Qualif. Ticket 10€(198756854)#003' 6-max (real money) Seat #3 is the button
Seat 1: manggy94 (3798)
Seat 2: LEurNzeproZe (3000)
Seat 3: VivlesBrelan (2720)
Seat 4: Mona.Lisa (1692)
Seat 5: Peter pAAn (3898)
Seat 6: MAYOUSSS (5080)
*** ANTE/BLINDS ***
Mona.Lisa posts ante 15
Peter pAAn posts ante 15
manggy94 posts ante 15
LEurNzeproZe posts ante 15
VivlesBrelan posts ante 15
MAYOUSSS posts ante 15
Mona.Lisa posts small blind 60
Peter pAAn posts big blind 120
Dealt to manggy94 [6s 3c]
*** PRE-FLOP *** 
MAYOUSSS raises 155 to 275
manggy94 folds
LEurNzeproZe folds
VivlesBrelan folds
Mona.Lisa folds
Peter pAAn calls 155
*** FLOP *** [Th 5h 8h]
Peter pAAn checks
MAYOUSSS checks
*** TURN *** [Th 5h 8h][2d]
Peter pAAn bets 350
MAYOUSSS folds
Peter pAAn collected 1050 from pot
*** SUMMARY ***
Total pot 1050 | No rake
Board: [Th 5h 8h 2d]
Seat 5: Peter pAAn (big blind) won 1050


Winamax Poker - Tournament "Qualif. Ticket 10€" buyIn: 1.80€ + 0.20€ level: 7 - HandId: #853654187785846788-25-1497872888 - Holdem no limit (15/60/120) - 2017/06/19 11:48:08 UTC
Table: 'Qualif. Ticket 10€(198756854)#003' 6-max (real money) Seat #4 is the button
Seat 1: manggy94 (3783)
Seat 2: LEurNzeproZe (2985)
Seat 3: VivlesBrelan (2705)
Seat 4: Mona.Lisa (1617)
Seat 5: Peter pAAn (4308)
Seat 6: MAYOUSSS (4790)
*** ANTE/BLINDS ***
Peter pAAn posts ante 15
MAYOUSSS posts ante 15
manggy94 posts ante 15
LEurNzeproZe posts ante 15
VivlesBrelan posts ante 15
Mona.Lisa posts ante 15
Peter pAAn posts small blind 60
MAYOUSSS posts big blind 120
Dealt to manggy94 [2h 5c]
*** PRE-FLOP *** 
manggy94 folds
LEurNzeproZe folds
VivlesBrelan raises 180 to 300
Mona.Lisa folds
Peter pAAn folds
MAYOUSSS folds
VivlesBrelan collected 570 from pot
*** SUMMARY ***
Total pot 570 | No rake
Seat 3: VivlesBrelan won 570


Winamax Poker - Tournament "Qualif. Ticket 10€" buyIn: 1.80€ + 0.20€ level: 7 - HandId: #853654187785846788-26-1497872920 - Holdem no limit (15/60/120) - 2017/06/19 11:48:40 UTC
Table: 'Qualif. Ticket 10€(198756854)#003' 6-max (real money) Seat #5 is the button
Seat 1: manggy94 (3768)
Seat 2: LEurNzeproZe (2970)
Seat 3: VivlesBrelan (2960)
Seat 4: Mona.Lisa (1602)
Seat 5: Peter pAAn (4233)
Seat 6: MAYOUSSS (4655)
*** ANTE/BLINDS ***
MAYOUSSS posts ante 15
manggy94 posts ante 15
LEurNzeproZe posts ante 15
VivlesBrelan posts ante 15
Mona.Lisa posts ante 15
Peter pAAn posts ante 15
MAYOUSSS posts small blind 60
manggy94 posts big blind 120
Dealt to manggy94 [9s Jc]
*** PRE-FLOP *** 
LEurNzeproZe folds
VivlesBrelan folds
Mona.Lisa folds
Peter pAAn folds
MAYOUSSS folds
manggy94 collected 270 from pot
*** SUMMARY ***
Total pot 270 | No rake
Seat 1: manggy94 (big blind) won 270


Winamax Poker - Tournament "Qualif. Ticket 10€" buyIn: 1.80€ + 0.20€ level: 7 - HandId: #853654187785846788-27-1497872953 - Holdem no limit (15/60/120) - 2017/06/19 11:49:13 UTC
Table: 'Qualif. Ticket 10€(198756854)#003' 6-max (real money) Seat #6 is the button
Seat 1: manggy94 (3903)
Seat 2: LEurNzeproZe (2955)
Seat 3: VivlesBrelan (2945)
Seat 4: Mona.Lisa (1587)
Seat 5: Peter pAAn (4218)
Seat 6: MAYOUSSS (4580)
*** ANTE/BLINDS ***
manggy94 posts ante 15
LEurNzeproZe posts ante 15
VivlesBrelan posts ante 15
Mona.Lisa posts ante 15
Peter pAAn posts ante 15
MAYOUSSS posts ante 15
manggy94 posts small blind 60
LEurNzeproZe posts big blind 120
Dealt to manggy94 [As 8h]
*** PRE-FLOP *** 
VivlesBrelan raises 120 to 240
Mona.Lisa folds
Peter pAAn folds
MAYOUSSS folds
manggy94 raises 120 to 360
LEurNzeproZe folds
VivlesBrelan raises 2570 to 2930 and is all-in
manggy94 calls 2570
*** FLOP *** [Ah 3s Jh]
*** TURN *** [Ah 3s Jh][Ac]
*** RIVER *** [Ah 3s Jh Ac][Jc]
*** SHOW DOWN ***
manggy94 shows [As 8h] (Full of Aces and Jacks)
VivlesBrelan shows [Qc Ad] (Full of Aces and Jacks)
VivlesBrelan collected 3035 from pot
manggy94 collected 3035 from pot
*** SUMMARY ***
Total pot 6070 | No rake
Board: [Ah 3s Jh Ac Jc]
Seat 1: manggy94 (small blind) showed [As 8h] and won 3035 with Full of Aces and Jacks
Seat 3: VivlesBrelan showed [Qc Ad] and won 3035 with Full of Aces and Jacks


Winamax Poker - Tournament "Qualif. Ticket 10€" buyIn: 1.80€ + 0.20€ level: 7 - HandId: #853654187785846788-28-1497873023 - Holdem no limit (15/60/120) - 2017/06/19 11:50:23 UTC
Table: 'Qualif. Ticket 10€(198756854)#003' 6-max (real money) Seat #1 is the button
Seat 1: manggy94 (3993)
Seat 2: LEurNzeproZe (2820)
Seat 3: VivlesBrelan (3035)
Seat 4: Mona.Lisa (1572)
Seat 5: Peter pAAn (4203)
Seat 6: MAYOUSSS (4565)
*** ANTE/BLINDS ***
LEurNzeproZe posts ante 15
VivlesBrelan posts ante 15
manggy94 posts ante 15
Mona.Lisa posts ante 15
Peter pAAn posts ante 15
MAYOUSSS posts ante 15
LEurNzeproZe posts small blind 60
VivlesBrelan posts big blind 120
Dealt to manggy94 [Qd Js]
*** PRE-FLOP *** 
Mona.Lisa folds
Peter pAAn folds
MAYOUSSS folds
manggy94 raises 120 to 240
LEurNzeproZe folds
VivlesBrelan folds
manggy94 collected 510 from pot
*** SUMMARY ***
Total pot 510 | No rake
Seat 1: manggy94 (button) won 510


Winamax Poker - Tournament "Qualif. Ticket 10€" buyIn: 1.80€ + 0.20€ level: 7 - HandId: #853654187785846788-29-1497873039 - Holdem no limit (15/60/120) - 2017/06/19 11:50:39 UTC
Table: 'Qualif. Ticket 10€(198756854)#003' 6-max (real money) Seat #2 is the button
Seat 1: manggy94 (4248)
Seat 2: LEurNzeproZe (2745)
Seat 3: VivlesBrelan (2900)
Seat 4: Mona.Lisa (1557)
Seat 5: Peter pAAn (4188)
Seat 6: MAYOUSSS (4550)
*** ANTE/BLINDS ***
VivlesBrelan posts ante 15
Mona.Lisa posts ante 15
manggy94 posts ante 15
LEurNzeproZe posts ante 15
Peter pAAn posts ante 15
MAYOUSSS posts ante 15
VivlesBrelan posts small blind 60
Mona.Lisa posts big blind 120
Dealt to manggy94 [Jc Kh]
*** PRE-FLOP *** 
Peter pAAn folds
MAYOUSSS folds
manggy94 raises 240 to 360
LEurNzeproZe folds
VivlesBrelan folds
Mona.Lisa raises 1182 to 1542 and is all-in
manggy94 calls 1182
*** FLOP *** [2s Qd Qc]
*** TURN *** [2s Qd Qc][2h]
*** RIVER *** [2s Qd Qc 2h][3c]
*** SHOW DOWN ***
manggy94 shows [Jc Kh] (Two pairs : Queens and 2)
Mona.Lisa shows [Ad Ts] (Two pairs : Queens and 2)
Mona.Lisa collected 3234 from pot
*** SUMMARY ***
Total pot 3234 | No rake
Board: [2s Qd Qc 2h 3c]
Seat 1: manggy94 showed [Jc Kh] and lost with Two pairs : Queens and 2
Seat 4: Mona.Lisa (big blind) showed [Ad Ts] and won 3234 with Two pairs : Queens and 2


Winamax Poker - Tournament "Qualif. Ticket 10€" buyIn: 1.80€ + 0.20€ level: 7 - HandId: #853654187785846788-30-1497873072 - Holdem no limit (15/60/120) - 2017/06/19 11:51:12 UTC
Table: 'Qualif. Ticket 10€(198756854)#003' 6-max (real money) Seat #3 is the button
Seat 1: manggy94 (2691)
Seat 2: LEurNzeproZe (2730)
Seat 3: VivlesBrelan (2825)
Seat 4: Mona.Lisa (3234)
Seat 5: Peter pAAn (4173)
Seat 6: MAYOUSSS (4535)
*** ANTE/BLINDS ***
Mona.Lisa posts ante 15
Peter pAAn posts ante 15
manggy94 posts ante 15
LEurNzeproZe posts ante 15
VivlesBrelan posts ante 15
MAYOUSSS posts ante 15
Mona.Lisa posts small blind 60
Peter pAAn posts big blind 120
Dealt to manggy94 [8s Td]
*** PRE-FLOP *** 
MAYOUSSS folds
manggy94 folds
LEurNzeproZe folds
VivlesBrelan folds
Mona.Lisa folds
Peter pAAn collected 270 from pot
*** SUMMARY ***
Total pot 270 | No rake
Seat 5: Peter pAAn (big blind) won 270


Winamax Poker - Tournament "Qualif. Ticket 10€" buyIn: 1.80€ + 0.20€ level: 7 - HandId: #853654187785846788-31-1497873084 - Holdem no limit (15/60/120) - 2017/06/19 11:51:24 UTC
Table: 'Qualif. Ticket 10€(198756854)#003' 6-max (real money) Seat #4 is the button
Seat 1: manggy94 (2676)
Seat 2: LEurNzeproZe (2715)
Seat 3: VivlesBrelan (2810)
Seat 4: Mona.Lisa (3159)
Seat 5: Peter pAAn (4308)
Seat 6: MAYOUSSS (4520)
*** ANTE/BLINDS ***
Peter pAAn posts ante 15
MAYOUSSS posts ante 15
manggy94 posts ante 15
LEurNzeproZe posts ante 15
VivlesBrelan posts ante 15
Mona.Lisa posts ante 15
Peter pAAn posts small blind 60
MAYOUSSS posts big blind 120
Dealt to manggy94 [Th 6h]
*** PRE-FLOP *** 
manggy94 folds
LEurNzeproZe raises 163 to 283
VivlesBrelan folds
Mona.Lisa folds
Peter pAAn folds
MAYOUSSS folds
LEurNzeproZe collected 553 from pot
*** SUMMARY ***
Total pot 553 | No rake
Seat 2: LEurNzeproZe won 553


Winamax Poker - Tournament "Qualif. Ticket 10€" buyIn: 1.80€ + 0.20€ level: 7 - HandId: #853654187785846788-32-1497873112 - Holdem no limit (15/60/120) - 2017/06/19 11:51:52 UTC
Table: 'Qualif. Ticket 10€(198756854)#003' 6-max (real money) Seat #5 is the button
Seat 1: manggy94 (2661)
Seat 2: LEurNzeproZe (2970)
Seat 3: VivlesBrelan (2795)
Seat 4: Mona.Lisa (3144)
Seat 5: Peter pAAn (4233)
Seat 6: MAYOUSSS (4385)
*** ANTE/BLINDS ***
MAYOUSSS posts ante 15
manggy94 posts ante 15
LEurNzeproZe posts ante 15
VivlesBrelan posts ante 15
Mona.Lisa posts ante 15
Peter pAAn posts ante 15
MAYOUSSS posts small blind 60
manggy94 posts big blind 120
Dealt to manggy94 [Ad Td]
*** PRE-FLOP *** 
LEurNzeproZe folds
VivlesBrelan folds
Mona.Lisa folds
Peter pAAn raises 156 to 276
MAYOUSSS folds
manggy94 raises 702 to 978
Peter pAAn folds
manggy94 collected 1404 from pot
*** SUMMARY ***
Total pot 1404 | No rake
Seat 1: manggy94 (big blind) won 1404


Winamax Poker - Tournament "Qualif. Ticket 10€" buyIn: 1.80€ + 0.20€ level: 8 - HandId: #853654187785846788-33-1497873159 - Holdem no limit (20/80/160) - 2017/06/19 11:52:39 UTC
Table: 'Qualif. Ticket 10€(198756854)#003' 6-max (real money) Seat #6 is the button
Seat 1: manggy94 (3072)
Seat 2: LEurNzeproZe (2955)
Seat 3: VivlesBrelan (2780)
Seat 4: Mona.Lisa (3129)
Seat 5: Peter pAAn (3942)
Seat 6: MAYOUSSS (4310)
*** ANTE/BLINDS ***
manggy94 posts ante 20
LEurNzeproZe posts ante 20
VivlesBrelan posts ante 20
Mona.Lisa posts ante 20
Peter pAAn posts ante 20
MAYOUSSS posts ante 20
manggy94 posts small blind 80
LEurNzeproZe posts big blind 160
Dealt to manggy94 [3s Qs]
*** PRE-FLOP *** 
VivlesBrelan folds
Mona.Lisa folds
Peter pAAn folds
MAYOUSSS folds
manggy94 raises 160 to 320
LEurNzeproZe folds
manggy94 collected 600 from pot
*** SUMMARY ***
Total pot 600 | No rake
Seat 1: manggy94 (small blind) won 600


Winamax Poker - Tournament "Qualif. Ticket 10€" buyIn: 1.80€ + 0.20€ level: 8 - HandId: #853654187785846788-34-1497873179 - Holdem no limit (20/80/160) - 2017/06/19 11:52:59 UTC
Table: 'Qualif. Ticket 10€(198756854)#003' 6-max (real money) Seat #1 is the button
Seat 1: manggy94 (3332)
Seat 2: LEurNzeproZe (2775)
Seat 3: VivlesBrelan (2760)
Seat 4: Mona.Lisa (3109)
Seat 5: Peter pAAn (3922)
Seat 6: MAYOUSSS (4290)
*** ANTE/BLINDS ***
LEurNzeproZe posts ante 20
VivlesBrelan posts ante 20
manggy94 posts ante 20
Mona.Lisa posts ante 20
Peter pAAn posts ante 20
MAYOUSSS posts ante 20
LEurNzeproZe posts small blind 80
VivlesBrelan posts big blind 160
Dealt to manggy94 [8d Th]
*** PRE-FLOP *** 
Mona.Lisa folds
Peter pAAn folds
MAYOUSSS folds
manggy94 raises 160 to 320
LEurNzeproZe folds
VivlesBrelan folds
manggy94 collected 680 from pot
*** SUMMARY ***
Total pot 680 | No rake
Seat 1: manggy94 (button) won 680


Winamax Poker - Tournament "Qualif. Ticket 10€" buyIn: 1.80€ + 0.20€ level: 8 - HandId: #853654187785846788-35-1497873193 - Holdem no limit (20/80/160) - 2017/06/19 11:53:13 UTC
Table: 'Qualif. Ticket 10€(198756854)#003' 6-max (real money) Seat #2 is the button
Seat 1: manggy94 (3672)
Seat 2: LEurNzeproZe (2675)
Seat 3: VivlesBrelan (2580)
Seat 4: Mona.Lisa (3089)
Seat 6: zwartlongti (2751)
*** ANTE/BLINDS ***
VivlesBrelan posts ante 20
Mona.Lisa posts ante 20
manggy94 posts ante 20
LEurNzeproZe posts ante 20
zwartlongti posts ante 20
VivlesBrelan posts small blind 80
Mona.Lisa posts big blind 160
Dealt to manggy94 [5c 4d]
*** PRE-FLOP *** 
zwartlongti folds
manggy94 folds
LEurNzeproZe raises 218 to 378
VivlesBrelan folds
Mona.Lisa folds
LEurNzeproZe collected 718 from pot
*** SUMMARY ***
Total pot 718 | No rake
Seat 2: LEurNzeproZe (button) won 718


Winamax Poker - Tournament "Qualif. Ticket 10€" buyIn: 1.80€ + 0.20€ level: 8 - HandId: #853654187785846788-36-1497873234 - Holdem no limit (20/80/160) - 2017/06/19 11:53:54 UTC
Table: 'Qualif. Ticket 10€(198756854)#003' 6-max (real money) Seat #3 is the button
Seat 1: manggy94 (3652)
Seat 2: LEurNzeproZe (2995)
Seat 3: VivlesBrelan (2480)
Seat 4: Mona.Lisa (2909)
Seat 6: zwartlongti (2731)
*** ANTE/BLINDS ***
Mona.Lisa posts ante 20
zwartlongti posts ante 20
manggy94 posts ante 20
LEurNzeproZe posts ante 20
VivlesBrelan posts ante 20
Mona.Lisa posts small blind 80
zwartlongti posts big blind 160
Dealt to manggy94 [2s 7h]
*** PRE-FLOP *** 
manggy94 folds
LEurNzeproZe folds
VivlesBrelan folds
Mona.Lisa folds
zwartlongti shows [6d Kc] (High card : King)
zwartlongti collected 340 from pot
*** SUMMARY ***
Total pot 340 | No rake
Seat 6: zwartlongti (big blind) showed [6d Kc] and won 340 with High card : King


Winamax Poker - Tournament "Qualif. Ticket 10€" buyIn: 1.80€ + 0.20€ level: 8 - HandId: #853654187785846788-37-1497873260 - Holdem no limit (20/80/160) - 2017/06/19 11:54:20 UTC
Table: 'Qualif. Ticket 10€(198756854)#003' 6-max (real money) Seat #4 is the button
Seat 1: manggy94 (3632)
Seat 2: LEurNzeproZe (2975)
Seat 3: VivlesBrelan (2460)
Seat 4: Mona.Lisa (2809)
Seat 6: zwartlongti (2891)
*** ANTE/BLINDS ***
zwartlongti posts ante 20
manggy94 posts ante 20
LEurNzeproZe posts ante 20
VivlesBrelan posts ante 20
Mona.Lisa posts ante 20
zwartlongti posts small blind 80
manggy94 posts big blind 160
Dealt to manggy94 [3s 8c]
*** PRE-FLOP *** 
LEurNzeproZe folds
VivlesBrelan folds
Mona.Lisa folds
zwartlongti folds
manggy94 collected 340 from pot
*** SUMMARY ***
Total pot 340 | No rake
Seat 1: manggy94 (big blind) won 340


Winamax Poker - Tournament "Qualif. Ticket 10€" buyIn: 1.80€ + 0.20€ level: 8 - HandId: #853654187785846788-38-1497873275 - Holdem no limit (20/80/160) - 2017/06/19 11:54:35 UTC
Table: 'Qualif. Ticket 10€(198756854)#003' 6-max (real money) Seat #6 is the button
Seat 1: manggy94 (3792)
Seat 3: VivlesBrelan (2440)
Seat 4: Mona.Lisa (2789)
Seat 5: rode2 (3000)
Seat 6: zwartlongti (2791)
*** ANTE/BLINDS ***
manggy94 posts ante 20
VivlesBrelan posts ante 20
Mona.Lisa posts ante 20
rode2 posts ante 20
zwartlongti posts ante 20
manggy94 posts small blind 80
VivlesBrelan posts big blind 160
Dealt to manggy94 [6h Th]
*** PRE-FLOP *** 
Mona.Lisa folds
rode2 calls 160
zwartlongti folds
manggy94 calls 80
VivlesBrelan checks
*** FLOP *** [As 7s 9s]
manggy94 checks
VivlesBrelan checks
rode2 checks
*** TURN *** [As 7s 9s][9h]
manggy94 checks
VivlesBrelan checks
rode2 checks
*** RIVER *** [As 7s 9s 9h][8h]
manggy94 bets 290
VivlesBrelan folds
rode2 folds
manggy94 collected 870 from pot
*** SUMMARY ***
Total pot 870 | No rake
Board: [As 7s 9s 9h 8h]
Seat 1: manggy94 (small blind) won 870


Winamax Poker - Tournament "Qualif. Ticket 10€" buyIn: 1.80€ + 0.20€ level: 8 - HandId: #853654187785846788-39-1497873603 - Holdem no limit (20/80/160) - 2017/06/19 12:00:03 UTC
Table: 'Qualif. Ticket 10€(198756854)#003' 6-max (real money) Seat #1 is the button
Seat 1: manggy94 (4192)
Seat 2: mons zz (3000)
Seat 3: VivlesBrelan (2260)
Seat 4: Mona.Lisa (2769)
Seat 5: rode2 (2820)
Seat 6: zwartlongti (2771)
*** ANTE/BLINDS ***
VivlesBrelan posts ante 20
Mona.Lisa posts ante 20
manggy94 posts ante 20
rode2 posts ante 20
zwartlongti posts ante 20
VivlesBrelan posts small blind 80
Mona.Lisa posts big blind 160
Dealt to manggy94 [9d Ah]
*** PRE-FLOP *** 
rode2 folds
zwartlongti folds
manggy94 raises 160 to 320
VivlesBrelan folds
Mona.Lisa folds
manggy94 collected 660 from pot
*** SUMMARY ***
Total pot 660 | No rake
Seat 1: manggy94 (button) won 660


Winamax Poker - Tournament "Qualif. Ticket 10€" buyIn: 1.80€ + 0.20€ level: 8 - HandId: #853654187785846788-40-1497873646 - Holdem no limit (20/80/160) - 2017/06/19 12:00:46 UTC
Table: 'Qualif. Ticket 10€(198756854)#003' 6-max (real money) Seat #3 is the button
Seat 1: manggy94 (4512)
Seat 2: mons zz (3000)
Seat 3: VivlesBrelan (2160)
Seat 4: Mona.Lisa (2589)
Seat 5: rode2 (2800)
Seat 6: zwartlongti (2751)
*** ANTE/BLINDS ***
Mona.Lisa posts ante 20
rode2 posts ante 20
manggy94 posts ante 20
mons zz posts ante 20
VivlesBrelan posts ante 20
zwartlongti posts ante 20
Mona.Lisa posts small blind 80
rode2 posts big blind 160
Dealt to manggy94 [Tc 4d]
*** PRE-FLOP *** 
zwartlongti folds
manggy94 folds
mons zz raises 320 to 480
VivlesBrelan raises 1660 to 2140 and is all-in
Mona.Lisa folds
rode2 folds
mons zz calls 1660
*** FLOP *** [5h 8d Ah]
*** TURN *** [5h 8d Ah][Ks]
*** RIVER *** [5h 8d Ah Ks][6c]
*** SHOW DOWN ***
mons zz shows [Qs Ac] (One pair : Aces)
VivlesBrelan shows [Ad Kc] (Two pairs : Aces and Kings)
VivlesBrelan collected 4640 from pot
*** SUMMARY ***
Total pot 4640 | No rake
Board: [5h 8d Ah Ks 6c]
Seat 2: mons zz showed [Qs Ac] and lost with One pair : Aces
Seat 3: VivlesBrelan (button) showed [Ad Kc] and won 4640 with Two pairs : Aces and Kings


Winamax Poker - Tournament "Qualif. Ticket 10€" buyIn: 1.80€ + 0.20€ level: 8 - HandId: #853654187785846788-41-1497873677 - Holdem no limit (20/80/160) - 2017/06/19 12:01:17 UTC
Table: 'Qualif. Ticket 10€(198756854)#003' 6-max (real money) Seat #4 is the button
Seat 1: manggy94 (4492)
Seat 2: mons zz (840)
Seat 3: VivlesBrelan (4640)
Seat 4: Mona.Lisa (2489)
Seat 5: rode2 (2620)
Seat 6: zwartlongti (2731)
*** ANTE/BLINDS ***
rode2 posts ante 20
zwartlongti posts ante 20
manggy94 posts ante 20
mons zz posts ante 20
VivlesBrelan posts ante 20
Mona.Lisa posts ante 20
rode2 posts small blind 80
zwartlongti posts big blind 160
Dealt to manggy94 [8h Th]
*** PRE-FLOP *** 
manggy94 folds
mons zz folds
VivlesBrelan folds
Mona.Lisa folds
rode2 calls 80
zwartlongti raises 2551 to 2711 and is all-in
rode2 calls 2440 and is all-in
*** FLOP *** [3s Kh 7d]
*** TURN *** [3s Kh 7d][Kc]
*** RIVER *** [3s Kh 7d Kc][4h]
*** SHOW DOWN ***
rode2 shows [Tc Ah] (One pair : Kings)
zwartlongti shows [As Js] (One pair : Kings)
zwartlongti collected 5431 from pot
*** SUMMARY ***
Total pot 5431 | No rake
Board: [3s Kh 7d Kc 4h]
Seat 5: rode2 (small blind) showed [Tc Ah] and lost with One pair : Kings
Seat 6: zwartlongti (big blind) showed [As Js] and won 5431 with One pair : Kings


Winamax Poker - Tournament "Qualif. Ticket 10€" buyIn: 1.80€ + 0.20€ level: 8 - HandId: #853654187785846788-42-1497873724 - Holdem no limit (20/80/160) - 2017/06/19 12:02:04 UTC
Table: 'Qualif. Ticket 10€(198756854)#003' 6-max (real money) Seat #5 is the button
Seat 1: manggy94 (4472)
Seat 2: mons zz (820)
Seat 3: VivlesBrelan (4620)
Seat 4: Mona.Lisa (2469)
Seat 6: zwartlongti (5431)
*** ANTE/BLINDS ***
zwartlongti posts ante 20
manggy94 posts ante 20
mons zz posts ante 20
VivlesBrelan posts ante 20
Mona.Lisa posts ante 20
zwartlongti posts small blind 80
manggy94 posts big blind 160
Dealt to manggy94 [2s Ah]
*** PRE-FLOP *** 
mons zz raises 640 to 800 and is all-in
VivlesBrelan folds
Mona.Lisa folds
zwartlongti folds
manggy94 calls 640
*** FLOP *** [Td 7d 7s]
*** TURN *** [Td 7d 7s][Tc]
*** RIVER *** [Td 7d 7s Tc][4c]
*** SHOW DOWN ***
manggy94 shows [2s Ah] (Two pairs : Tens and 7)
mons zz shows [As 6d] (Two pairs : Tens and 7)
mons zz collected 890 from pot
manggy94 collected 890 from pot
*** SUMMARY ***
Total pot 1780 | No rake
Board: [Td 7d 7s Tc 4c]
Seat 1: manggy94 (big blind) showed [2s Ah] and won 890 with Two pairs : Tens and 7
Seat 2: mons zz showed [As 6d] and won 890 with Two pairs : Tens and 7


Winamax Poker - Tournament "Qualif. Ticket 10€" buyIn: 1.80€ + 0.20€ level: 8 - HandId: #853654187785846788-43-1497873749 - Holdem no limit (20/80/160) - 2017/06/19 12:02:29 UTC
Table: 'Qualif. Ticket 10€(198756854)#003' 6-max (real money) Seat #6 is the button
Seat 1: manggy94 (4542)
Seat 2: mons zz (890)
Seat 3: VivlesBrelan (4600)
Seat 4: Mona.Lisa (2449)
Seat 6: zwartlongti (5331)
*** ANTE/BLINDS ***
manggy94 posts ante 20
mons zz posts ante 20
VivlesBrelan posts ante 20
Mona.Lisa posts ante 20
zwartlongti posts ante 20
manggy94 posts small blind 80
mons zz posts big blind 160
Dealt to manggy94 [Ks Kh]
*** PRE-FLOP *** 
VivlesBrelan folds
Mona.Lisa folds
zwartlongti folds
manggy94 calls 80
mons zz checks
*** FLOP *** [4h Qh 4c]
manggy94 checks
mons zz bets 710 and is all-in
manggy94 calls 710
*** TURN *** [4h Qh 4c][Ts]
*** RIVER *** [4h Qh 4c Ts][5h]
*** SHOW DOWN ***
mons zz shows [7c Qd] (Two pairs : Queens and 4)
manggy94 shows [Ks Kh] (Two pairs : Kings and 4)
manggy94 collected 1840 from pot
*** SUMMARY ***
Total pot 1840 | No rake
Board: [4h Qh 4c Ts 5h]
Seat 1: manggy94 (small blind) showed [Ks Kh] and won 1840 with Two pairs : Kings and 4
Seat 2: mons zz (big blind) showed [7c Qd] and lost with Two pairs : Queens and 4


Winamax Poker - Tournament "Qualif. Ticket 10€" buyIn: 1.80€ + 0.20€ level: 9 - HandId: #853654187785846788-44-1497873835 - Holdem no limit (25/100/200) - 2017/06/19 12:03:55 UTC
Table: 'Qualif. Ticket 10€(198756854)#003' 6-max (real money) Seat #1 is the button
Seat 1: manggy94 (5492)
Seat 3: VivlesBrelan (4580)
Seat 4: Mona.Lisa (2429)
Seat 5: -Thierno- (3000)
Seat 6: zwartlongti (5311)
*** ANTE/BLINDS ***
VivlesBrelan posts ante 25
manggy94 posts ante 25
Mona.Lisa posts ante 25
-Thierno- posts ante 25
zwartlongti posts ante 25
VivlesBrelan posts big blind 200
Dealt to manggy94 [9d 8h]
*** PRE-FLOP *** 
Mona.Lisa folds
-Thierno- folds
zwartlongti calls 200
manggy94 calls 200
VivlesBrelan checks
*** FLOP *** [Ad 3c Ts]
VivlesBrelan bets 363
zwartlongti calls 363
manggy94 folds
*** TURN *** [Ad 3c Ts][6h]
VivlesBrelan bets 726
zwartlongti folds
VivlesBrelan collected 2177 from pot
*** SUMMARY ***
Total pot 2177 | No rake
Board: [Ad 3c Ts 6h]
Seat 3: VivlesBrelan (big blind) won 2177


Winamax Poker - Tournament "Qualif. Ticket 10€" buyIn: 1.80€ + 0.20€ level: 9 - HandId: #853654187785846788-45-1497873885 - Holdem no limit (25/100/200) - 2017/06/19 12:04:45 UTC
Table: 'Qualif. Ticket 10€(198756854)#003' 6-max (real money) Seat #2 is the button
Seat 1: manggy94 (5267)
Seat 3: VivlesBrelan (5443)
Seat 4: Mona.Lisa (2404)
Seat 5: -Thierno- (2975)
Seat 6: zwartlongti (4723)
*** ANTE/BLINDS ***
VivlesBrelan posts ante 25
Mona.Lisa posts ante 25
manggy94 posts ante 25
-Thierno- posts ante 25
zwartlongti posts ante 25
VivlesBrelan posts small blind 100
Mona.Lisa posts big blind 200
Dealt to manggy94 [7h Ad]
*** PRE-FLOP *** 
-Thierno- folds
zwartlongti folds
manggy94 raises 400 to 600
VivlesBrelan folds
Mona.Lisa calls 400
*** FLOP *** [Qc Tc Js]
Mona.Lisa checks
manggy94 bets 700
Mona.Lisa raises 1079 to 1779 and is all-in
manggy94 calls 1079
*** TURN *** [Qc Tc Js][Jh]
*** RIVER *** [Qc Tc Js Jh][7d]
*** SHOW DOWN ***
manggy94 shows [7h Ad] (Two pairs : Jacks and 7)
Mona.Lisa shows [Jd Qh] (Full of Jacks and Queens)
Mona.Lisa collected 4983 from pot
*** SUMMARY ***
Total pot 4983 | No rake
Board: [Qc Tc Js Jh 7d]
Seat 1: manggy94 showed [7h Ad] and lost with Two pairs : Jacks and 7
Seat 4: Mona.Lisa (big blind) showed [Jd Qh] and won 4983 with Full of Jacks and Queens


Winamax Poker - Tournament "Qualif. Ticket 10€" buyIn: 1.80€ + 0.20€ level: 9 - HandId: #853654187785846786-63-1497873969 - Holdem no limit (25/100/200) - 2017/06/19 12:06:09 UTC
Table: 'Qualif. Ticket 10€(198756854)#001' 6-max (real money) Seat #4 is the button
Seat 1: manggy94 (2863)
Seat 2: MAYOUSSS (4260)
Seat 3: Labiffle. (9488)
Seat 4: VivlesBrelan (5318)
Seat 5: G4NG B4NG (7285)
Seat 6: Roselie82 (9775)
*** ANTE/BLINDS ***
G4NG B4NG posts ante 25
Roselie82 posts ante 25
manggy94 posts ante 25
MAYOUSSS posts ante 25
Labiffle. posts ante 25
VivlesBrelan posts ante 25
G4NG B4NG posts small blind 100
Roselie82 posts big blind 200
Dealt to manggy94 [6c Ah]
*** PRE-FLOP *** 
manggy94 calls 200
MAYOUSSS folds
Labiffle. folds
VivlesBrelan folds
G4NG B4NG folds
Roselie82 checks
*** FLOP *** [5h 6d 2c]
Roselie82 checks
manggy94 bets 200
Roselie82 folds
manggy94 collected 850 from pot
*** SUMMARY ***
Total pot 850 | No rake
Board: [5h 6d 2c]
Seat 1: manggy94 won 850


Winamax Poker - Tournament "Qualif. Ticket 10€" buyIn: 1.80€ + 0.20€ level: 9 - HandId: #853654187785846786-64-1497874009 - Holdem no limit (25/100/200) - 2017/06/19 12:06:49 UTC
Table: 'Qualif. Ticket 10€(198756854)#001' 6-max (real money) Seat #5 is the button
Seat 1: manggy94 (3288)
Seat 2: MAYOUSSS (4235)
Seat 3: Labiffle. (9463)
Seat 4: VivlesBrelan (5293)
Seat 5: G4NG B4NG (7160)
Seat 6: Roselie82 (9550)
*** ANTE/BLINDS ***
Roselie82 posts ante 25
manggy94 posts ante 25
MAYOUSSS posts ante 25
Labiffle. posts ante 25
VivlesBrelan posts ante 25
G4NG B4NG posts ante 25
Roselie82 posts small blind 100
manggy94 posts big blind 200
Dealt to manggy94 [7c 4c]
*** PRE-FLOP *** 
MAYOUSSS folds
Labiffle. calls 200
VivlesBrelan folds
G4NG B4NG calls 200
Roselie82 folds
manggy94 checks
*** FLOP *** [Kd Qc Jh]
manggy94 checks
Labiffle. checks
G4NG B4NG checks
*** TURN *** [Kd Qc Jh][9d]
manggy94 checks
Labiffle. bets 200
G4NG B4NG folds
manggy94 folds
Labiffle. collected 1050 from pot
*** SUMMARY ***
Total pot 1050 | No rake
Board: [Kd Qc Jh 9d]
Seat 3: Labiffle. won 1050


Winamax Poker - Tournament "Qualif. Ticket 10€" buyIn: 1.80€ + 0.20€ level: 9 - HandId: #853654187785846786-65-1497874071 - Holdem no limit (25/100/200) - 2017/06/19 12:07:51 UTC
Table: 'Qualif. Ticket 10€(198756854)#001' 6-max (real money) Seat #6 is the button
Seat 1: manggy94 (3063)
Seat 2: MAYOUSSS (4210)
Seat 3: Labiffle. (10088)
Seat 4: VivlesBrelan (5268)
Seat 5: G4NG B4NG (6935)
Seat 6: Roselie82 (9425)
*** ANTE/BLINDS ***
manggy94 posts ante 25
MAYOUSSS posts ante 25
Labiffle. posts ante 25
VivlesBrelan posts ante 25
G4NG B4NG posts ante 25
Roselie82 posts ante 25
manggy94 posts small blind 100
MAYOUSSS posts big blind 200
Dealt to manggy94 [5d 9c]
*** PRE-FLOP *** 
Labiffle. folds
VivlesBrelan folds
G4NG B4NG folds
Roselie82 folds
manggy94 calls 100
MAYOUSSS checks
*** FLOP *** [8d Qd 6c]
manggy94 bets 275
MAYOUSSS folds
manggy94 collected 825 from pot
*** SUMMARY ***
Total pot 825 | No rake
Board: [8d Qd 6c]
Seat 1: manggy94 (small blind) won 825


Winamax Poker - Tournament "Qualif. Ticket 10€" buyIn: 1.80€ + 0.20€ level: 9 - HandId: #853654187785846786-66-1497874113 - Holdem no limit (25/100/200) - 2017/06/19 12:08:33 UTC
Table: 'Qualif. Ticket 10€(198756854)#001' 6-max (real money) Seat #1 is the button
Seat 1: manggy94 (3388)
Seat 2: MAYOUSSS (3985)
Seat 3: Labiffle. (10063)
Seat 4: VivlesBrelan (5243)
Seat 5: G4NG B4NG (6910)
Seat 6: Roselie82 (9400)
*** ANTE/BLINDS ***
MAYOUSSS posts ante 25
Labiffle. posts ante 25
manggy94 posts ante 25
VivlesBrelan posts ante 25
G4NG B4NG posts ante 25
Roselie82 posts ante 25
MAYOUSSS posts small blind 100
Labiffle. posts big blind 200
Dealt to manggy94 [Tc 2h]
*** PRE-FLOP *** 
VivlesBrelan folds
G4NG B4NG folds
Roselie82 folds
manggy94 folds
MAYOUSSS raises 258 to 458
Labiffle. folds
MAYOUSSS collected 808 from pot
*** SUMMARY ***
Total pot 808 | No rake
Seat 2: MAYOUSSS (small blind) won 808


Winamax Poker - Tournament "Qualif. Ticket 10€" buyIn: 1.80€ + 0.20€ level: 9 - HandId: #853654187785846786-67-1497874132 - Holdem no limit (25/100/200) - 2017/06/19 12:08:52 UTC
Table: 'Qualif. Ticket 10€(198756854)#001' 6-max (real money) Seat #2 is the button
Seat 1: manggy94 (3363)
Seat 2: MAYOUSSS (4310)
Seat 3: Labiffle. (9838)
Seat 4: VivlesBrelan (5218)
Seat 5: G4NG B4NG (6885)
Seat 6: Roselie82 (9375)
*** ANTE/BLINDS ***
Labiffle. posts ante 25
VivlesBrelan posts ante 25
manggy94 posts ante 25
MAYOUSSS posts ante 25
G4NG B4NG posts ante 25
Roselie82 posts ante 25
Labiffle. posts small blind 100
VivlesBrelan posts big blind 200
Dealt to manggy94 [3d 7s]
*** PRE-FLOP *** 
G4NG B4NG raises 300 to 500
Roselie82 calls 500
manggy94 folds
MAYOUSSS folds
Labiffle. folds
VivlesBrelan folds
*** FLOP *** [4d 2h As]
G4NG B4NG checks
Roselie82 checks
*** TURN *** [4d 2h As][2c]
G4NG B4NG bets 200
Roselie82 folds
G4NG B4NG collected 1650 from pot
*** SUMMARY ***
Total pot 1650 | No rake
Board: [4d 2h As 2c]
Seat 5: G4NG B4NG won 1650


Winamax Poker - Tournament "Qualif. Ticket 10€" buyIn: 1.80€ + 0.20€ level: 10 - HandId: #853654187785846786-68-1497874164 - Holdem no limit (30/125/250) - 2017/06/19 12:09:24 UTC
Table: 'Qualif. Ticket 10€(198756854)#001' 6-max (real money) Seat #3 is the button
Seat 1: manggy94 (3338)
Seat 2: MAYOUSSS (4285)
Seat 3: Labiffle. (9713)
Seat 4: VivlesBrelan (4993)
Seat 5: G4NG B4NG (7810)
Seat 6: Roselie82 (8850)
*** ANTE/BLINDS ***
VivlesBrelan posts ante 30
G4NG B4NG posts ante 30
manggy94 posts ante 30
MAYOUSSS posts ante 30
Labiffle. posts ante 30
Roselie82 posts ante 30
VivlesBrelan posts small blind 125
G4NG B4NG posts big blind 250
Dealt to manggy94 [5d Jd]
*** PRE-FLOP *** 
Roselie82 folds
manggy94 folds
MAYOUSSS folds
Labiffle. calls 250
VivlesBrelan folds
G4NG B4NG checks
*** FLOP *** [4d Qc 7c]
G4NG B4NG checks
Labiffle. bets 805
G4NG B4NG folds
Labiffle. collected 1610 from pot
*** SUMMARY ***
Total pot 1610 | No rake
Board: [4d Qc 7c]
Seat 3: Labiffle. (button) won 1610


Winamax Poker - Tournament "Qualif. Ticket 10€" buyIn: 1.80€ + 0.20€ level: 10 - HandId: #853654187785846786-69-1497874189 - Holdem no limit (30/125/250) - 2017/06/19 12:09:49 UTC
Table: 'Qualif. Ticket 10€(198756854)#001' 6-max (real money) Seat #4 is the button
Seat 1: manggy94 (3308)
Seat 2: MAYOUSSS (4255)
Seat 3: Labiffle. (10238)
Seat 4: VivlesBrelan (4838)
Seat 5: G4NG B4NG (7530)
Seat 6: Roselie82 (8820)
*** ANTE/BLINDS ***
G4NG B4NG posts ante 30
Roselie82 posts ante 30
manggy94 posts ante 30
MAYOUSSS posts ante 30
Labiffle. posts ante 30
VivlesBrelan posts ante 30
G4NG B4NG posts small blind 125
Roselie82 posts big blind 250
Dealt to manggy94 [6c Ks]
*** PRE-FLOP *** 
manggy94 folds
MAYOUSSS folds
Labiffle. calls 250
VivlesBrelan folds
G4NG B4NG folds
Roselie82 checks
*** FLOP *** [9h Jc Jd]
Roselie82 checks
Labiffle. checks
*** TURN *** [9h Jc Jd][7s]
Roselie82 checks
Labiffle. bets 250
Roselie82 folds
Labiffle. collected 1055 from pot
*** SUMMARY ***
Total pot 1055 | No rake
Board: [9h Jc Jd 7s]
Seat 3: Labiffle. won 1055


Winamax Poker - Tournament "Qualif. Ticket 10€" buyIn: 1.80€ + 0.20€ level: 10 - HandId: #853654187785846786-70-1497874220 - Holdem no limit (30/125/250) - 2017/06/19 12:10:20 UTC
Table: 'Qualif. Ticket 10€(198756854)#001' 6-max (real money) Seat #5 is the button
Seat 1: manggy94 (3278)
Seat 2: MAYOUSSS (4225)
Seat 3: Labiffle. (10763)
Seat 4: VivlesBrelan (4808)
Seat 5: G4NG B4NG (7375)
Seat 6: Roselie82 (8540)
*** ANTE/BLINDS ***
Roselie82 posts ante 30
manggy94 posts ante 30
MAYOUSSS posts ante 30
Labiffle. posts ante 30
VivlesBrelan posts ante 30
G4NG B4NG posts ante 30
Roselie82 posts small blind 125
manggy94 posts big blind 250
Dealt to manggy94 [4h 4d]
*** PRE-FLOP *** 
MAYOUSSS folds
Labiffle. calls 250
VivlesBrelan folds
G4NG B4NG calls 250
Roselie82 folds
manggy94 checks
*** FLOP *** [Jd 4c 2c]
manggy94 checks
Labiffle. bets 250
G4NG B4NG folds
manggy94 raises 250 to 500
Labiffle. calls 250
*** TURN *** [Jd 4c 2c][As]
manggy94 checks
Labiffle. bets 9983 and is all-in
manggy94 calls 2498 and is all-in
*** RIVER *** [Jd 4c 2c As][Jh]
*** SHOW DOWN ***
manggy94 shows [4h 4d] (Full of 4 and Jacks)
Labiffle. shows [Js Kh] (Trips of Jacks)
Labiffle. collected 7485 from side pot 1
manggy94 collected 7051 from main pot
*** SUMMARY ***
Total pot 14536 | No rake
Board: [Jd 4c 2c As Jh]
Seat 1: manggy94 (big blind) showed [4h 4d] and won 7051 with Full of 4 and Jacks
Seat 3: Labiffle. showed [Js Kh] and won 7485 with Trips of Jacks


Winamax Poker - Tournament "Qualif. Ticket 10€" buyIn: 1.80€ + 0.20€ level: 10 - HandId: #853654187785846786-71-1497874287 - Holdem no limit (30/125/250) - 2017/06/19 12:11:27 UTC
Table: 'Qualif. Ticket 10€(198756854)#001' 6-max (real money) Seat #6 is the button
Seat 1: manggy94 (7051)
Seat 2: MAYOUSSS (4195)
Seat 3: Labiffle. (7485)
Seat 4: VivlesBrelan (4778)
Seat 5: G4NG B4NG (7095)
Seat 6: Roselie82 (8385)
*** ANTE/BLINDS ***
manggy94 posts ante 30
MAYOUSSS posts ante 30
Labiffle. posts ante 30
VivlesBrelan posts ante 30
G4NG B4NG posts ante 30
Roselie82 posts ante 30
manggy94 posts small blind 125
MAYOUSSS posts big blind 250
Dealt to manggy94 [8h 5c]
*** PRE-FLOP *** 
Labiffle. calls 250
VivlesBrelan folds
G4NG B4NG folds
Roselie82 folds
manggy94 folds
MAYOUSSS checks
*** FLOP *** [4d 3c Jd]
MAYOUSSS bets 375
Labiffle. folds
MAYOUSSS collected 1180 from pot
*** SUMMARY ***
Total pot 1180 | No rake
Board: [4d 3c Jd]
Seat 2: MAYOUSSS (big blind) won 1180


Winamax Poker - Tournament "Qualif. Ticket 10€" buyIn: 1.80€ + 0.20€ level: 10 - HandId: #853654187785846786-72-1497874330 - Holdem no limit (30/125/250) - 2017/06/19 12:12:10 UTC
Table: 'Qualif. Ticket 10€(198756854)#001' 6-max (real money) Seat #1 is the button
Seat 1: manggy94 (6896)
Seat 2: MAYOUSSS (4720)
Seat 3: Labiffle. (7205)
Seat 4: VivlesBrelan (4748)
Seat 5: G4NG B4NG (7065)
Seat 6: Roselie82 (8355)
*** ANTE/BLINDS ***
MAYOUSSS posts ante 30
Labiffle. posts ante 30
manggy94 posts ante 30
VivlesBrelan posts ante 30
G4NG B4NG posts ante 30
Roselie82 posts ante 30
MAYOUSSS posts small blind 125
Labiffle. posts big blind 250
Dealt to manggy94 [As Ah]
*** PRE-FLOP *** 
VivlesBrelan folds
G4NG B4NG folds
Roselie82 folds
manggy94 calls 250
MAYOUSSS calls 125
Labiffle. raises 250 to 500
manggy94 raises 250 to 750
MAYOUSSS folds
Labiffle. raises 250 to 1000
manggy94 raises 250 to 1250
Labiffle. raises 5925 to 7175 and is all-in
manggy94 calls 5616 and is all-in
*** FLOP *** [9h 6d 8h]
*** TURN *** [9h 6d 8h][2d]
*** RIVER *** [9h 6d 8h 2d][3d]
*** SHOW DOWN ***
manggy94 shows [As Ah] (One pair : Aces)
Labiffle. shows [Ac 6s] (One pair : 6)
Labiffle. collected 309 from side pot 1
manggy94 collected 14162 from main pot
*** SUMMARY ***
Total pot 14471 | No rake
Board: [9h 6d 8h 2d 3d]
Seat 1: manggy94 (button) showed [As Ah] and won 14162 with One pair : Aces
Seat 3: Labiffle. (big blind) showed [Ac 6s] and won 309 with One pair : 6


Winamax Poker - Tournament "Qualif. Ticket 10€" buyIn: 1.80€ + 0.20€ level: 10 - HandId: #853654187785846786-73-1497874386 - Holdem no limit (30/125/250) - 2017/06/19 12:13:06 UTC
Table: 'Qualif. Ticket 10€(198756854)#001' 6-max (real money) Seat #2 is the button
Seat 1: manggy94 (14162)
Seat 2: MAYOUSSS (4440)
Seat 3: Labiffle. (309)
Seat 4: VivlesBrelan (4718)
Seat 5: G4NG B4NG (7035)
Seat 6: Roselie82 (8325)
*** ANTE/BLINDS ***
Labiffle. posts ante 30
VivlesBrelan posts ante 30
manggy94 posts ante 30
MAYOUSSS posts ante 30
G4NG B4NG posts ante 30
Roselie82 posts ante 30
Labiffle. posts small blind 125
VivlesBrelan posts big blind 250
Dealt to manggy94 [6s 5d]
*** PRE-FLOP *** 
G4NG B4NG folds
Roselie82 raises 250 to 500
manggy94 folds
MAYOUSSS folds
Labiffle. calls 154 and is all-in
VivlesBrelan calls 250
*** FLOP *** [9c 4c Tc]
VivlesBrelan checks
Roselie82 bets 730
VivlesBrelan folds
*** TURN *** [9c 4c Tc][3c]
*** RIVER *** [9c 4c Tc 3c][Qd]
*** SHOW DOWN ***
Labiffle. shows [7d Ad] (High card : Ace)
Roselie82 shows [Jh Qc] (Flush Queen high)
Roselie82 collected 2189 from pot
*** SUMMARY ***
Total pot 2189 | No rake
Board: [9c 4c Tc 3c Qd]
Seat 3: Labiffle. (small blind) showed [7d Ad] and lost with High card : Ace
Seat 6: Roselie82 showed [Jh Qc] and won 2189 with Flush Queen high


Winamax Poker - Tournament "Qualif. Ticket 10€" buyIn: 1.80€ + 0.20€ level: 10 - HandId: #853654187785846786-74-1497874448 - Holdem no limit (30/125/250) - 2017/06/19 12:14:08 UTC
Table: 'Qualif. Ticket 10€(198756854)#001' 6-max (real money) Seat #3 is the button
Seat 1: manggy94 (14132)
Seat 2: MAYOUSSS (4410)
Seat 4: VivlesBrelan (4188)
Seat 5: G4NG B4NG (7005)
Seat 6: Roselie82 (9254)
*** ANTE/BLINDS ***
VivlesBrelan posts ante 30
G4NG B4NG posts ante 30
manggy94 posts ante 30
MAYOUSSS posts ante 30
Roselie82 posts ante 30
VivlesBrelan posts small blind 125
G4NG B4NG posts big blind 250
Dealt to manggy94 [Td Ks]
*** PRE-FLOP *** 
Roselie82 folds
manggy94 calls 250
MAYOUSSS folds
VivlesBrelan calls 125
G4NG B4NG checks
*** FLOP *** [5c Ts Qd]
VivlesBrelan checks
G4NG B4NG checks
manggy94 bets 450
VivlesBrelan folds
G4NG B4NG folds
manggy94 collected 1350 from pot
*** SUMMARY ***
Total pot 1350 | No rake
Board: [5c Ts Qd]
Seat 1: manggy94 won 1350


Winamax Poker - Tournament "Qualif. Ticket 10€" buyIn: 1.80€ + 0.20€ level: 11 - HandId: #853654187785846786-75-1497874510 - Holdem no limit (40/150/300) - 2017/06/19 12:15:10 UTC
Table: 'Qualif. Ticket 10€(198756854)#001' 6-max (real money) Seat #4 is the button
Seat 1: manggy94 (14752)
Seat 2: MAYOUSSS (4380)
Seat 4: VivlesBrelan (3908)
Seat 5: G4NG B4NG (6725)
Seat 6: Roselie82 (9224)
*** ANTE/BLINDS ***
G4NG B4NG posts ante 40
Roselie82 posts ante 40
manggy94 posts ante 40
MAYOUSSS posts ante 40
VivlesBrelan posts ante 40
G4NG B4NG posts small blind 150
Roselie82 posts big blind 300
Dealt to manggy94 [7h Qh]
*** PRE-FLOP *** 
manggy94 folds
MAYOUSSS raises 387 to 687
VivlesBrelan folds
G4NG B4NG folds
Roselie82 folds
MAYOUSSS collected 1337 from pot
*** SUMMARY ***
Total pot 1337 | No rake
Seat 2: MAYOUSSS won 1337


Winamax Poker - Tournament "Qualif. Ticket 10€" buyIn: 1.80€ + 0.20€ level: 11 - HandId: #853654187785846786-76-1497874522 - Holdem no limit (40/150/300) - 2017/06/19 12:15:22 UTC
Table: 'Qualif. Ticket 10€(198756854)#001' 6-max (real money) Seat #5 is the button
Seat 1: manggy94 (14712)
Seat 2: MAYOUSSS (4990)
Seat 4: VivlesBrelan (3868)
Seat 5: G4NG B4NG (6535)
Seat 6: Roselie82 (8884)
*** ANTE/BLINDS ***
Roselie82 posts ante 40
manggy94 posts ante 40
MAYOUSSS posts ante 40
VivlesBrelan posts ante 40
G4NG B4NG posts ante 40
Roselie82 posts small blind 150
manggy94 posts big blind 300
Dealt to manggy94 [9d 5c]
*** PRE-FLOP *** 
MAYOUSSS folds
VivlesBrelan folds
G4NG B4NG raises 300 to 600
Roselie82 folds
manggy94 folds
G4NG B4NG collected 1250 from pot
*** SUMMARY ***
Total pot 1250 | No rake
Seat 5: G4NG B4NG (button) won 1250


Winamax Poker - Tournament "Qualif. Ticket 10€" buyIn: 1.80€ + 0.20€ level: 11 - HandId: #853654187785846786-77-1497874544 - Holdem no limit (40/150/300) - 2017/06/19 12:15:44 UTC
Table: 'Qualif. Ticket 10€(198756854)#001' 6-max (real money) Seat #6 is the button
Seat 1: manggy94 (14372)
Seat 2: MAYOUSSS (4950)
Seat 4: VivlesBrelan (3828)
Seat 5: G4NG B4NG (7145)
Seat 6: Roselie82 (8694)
*** ANTE/BLINDS ***
manggy94 posts ante 40
MAYOUSSS posts ante 40
VivlesBrelan posts ante 40
G4NG B4NG posts ante 40
Roselie82 posts ante 40
manggy94 posts small blind 150
MAYOUSSS posts big blind 300
Dealt to manggy94 [Ad 8c]
*** PRE-FLOP *** 
VivlesBrelan folds
G4NG B4NG folds
Roselie82 folds
manggy94 raises 300 to 600
MAYOUSSS folds
manggy94 collected 1100 from pot
*** SUMMARY ***
Total pot 1100 | No rake
Seat 1: manggy94 (small blind) won 1100


Winamax Poker - Tournament "Qualif. Ticket 10€" buyIn: 1.80€ + 0.20€ level: 11 - HandId: #853654187785846786-78-1497874559 - Holdem no limit (40/150/300) - 2017/06/19 12:15:59 UTC
Table: 'Qualif. Ticket 10€(198756854)#001' 6-max (real money) Seat #1 is the button
Seat 1: manggy94 (14832)
Seat 2: MAYOUSSS (4610)
Seat 4: VivlesBrelan (3788)
Seat 5: G4NG B4NG (7105)
Seat 6: Roselie82 (8654)
*** ANTE/BLINDS ***
MAYOUSSS posts ante 40
VivlesBrelan posts ante 40
manggy94 posts ante 40
G4NG B4NG posts ante 40
Roselie82 posts ante 40
MAYOUSSS posts small blind 150
VivlesBrelan posts big blind 300
Dealt to manggy94 [5s Qc]
*** PRE-FLOP *** 
G4NG B4NG folds
Roselie82 folds
manggy94 folds
MAYOUSSS folds
VivlesBrelan collected 650 from pot
*** SUMMARY ***
Total pot 650 | No rake
Seat 4: VivlesBrelan (big blind) won 650


Winamax Poker - Tournament "Qualif. Ticket 10€" buyIn: 1.80€ + 0.20€ level: 11 - HandId: #853654187785846786-79-1497874576 - Holdem no limit (40/150/300) - 2017/06/19 12:16:16 UTC
Table: 'Qualif. Ticket 10€(198756854)#001' 6-max (real money) Seat #2 is the button
Seat 1: manggy94 (14792)
Seat 2: MAYOUSSS (4420)
Seat 4: VivlesBrelan (4098)
Seat 5: G4NG B4NG (7065)
Seat 6: Roselie82 (8614)
*** ANTE/BLINDS ***
VivlesBrelan posts ante 40
G4NG B4NG posts ante 40
manggy94 posts ante 40
MAYOUSSS posts ante 40
Roselie82 posts ante 40
VivlesBrelan posts small blind 150
G4NG B4NG posts big blind 300
Dealt to manggy94 [4d 4h]
*** PRE-FLOP *** 
Roselie82 raises 900 to 1200
manggy94 folds
MAYOUSSS folds
VivlesBrelan folds
G4NG B4NG folds
Roselie82 collected 1850 from pot
*** SUMMARY ***
Total pot 1850 | No rake
Seat 6: Roselie82 won 1850


Winamax Poker - Tournament "Qualif. Ticket 10€" buyIn: 1.80€ + 0.20€ level: 11 - HandId: #853654187785846786-80-1497874614 - Holdem no limit (40/150/300) - 2017/06/19 12:16:54 UTC
Table: 'Qualif. Ticket 10€(198756854)#001' 6-max (real money) Seat #4 is the button
Seat 1: manggy94 (14752)
Seat 2: MAYOUSSS (4380)
Seat 4: VivlesBrelan (3908)
Seat 5: G4NG B4NG (6725)
Seat 6: Roselie82 (9224)
*** ANTE/BLINDS ***
G4NG B4NG posts ante 40
Roselie82 posts ante 40
manggy94 posts ante 40
MAYOUSSS posts ante 40
VivlesBrelan posts ante 40
G4NG B4NG posts small blind 150
Roselie82 posts big blind 300
Dealt to manggy94 [5s Kc]
*** PRE-FLOP *** 
manggy94 folds
MAYOUSSS raises 387 to 687
VivlesBrelan folds
G4NG B4NG folds
Roselie82 folds
MAYOUSSS collected 1337 from pot
*** SUMMARY ***
Total pot 1337 | No rake
Seat 2: MAYOUSSS won 1337


Winamax Poker - Tournament "Qualif. Ticket 10€" buyIn: 1.80€ + 0.20€ level: 11 - HandId: #853654187785846786-81-1497874644 - Holdem no limit (40/150/300) - 2017/06/19 12:17:24 UTC
Table: 'Qualif. Ticket 10€(198756854)#001' 6-max (real money) Seat #5 is the button
Seat 1: manggy94 (14712)
Seat 2: MAYOUSSS (4990)
Seat 4: VivlesBrelan (3868)
Seat 5: G4NG B4NG (6535)
Seat 6: Roselie82 (8884)
*** ANTE/BLINDS ***
Roselie82 posts ante 40
manggy94 posts ante 40
MAYOUSSS posts ante 40
VivlesBrelan posts ante 40
G4NG B4NG posts ante 40
Roselie82 posts small blind 150
manggy94 posts big blind 300
Dealt to manggy94 [2d 9d]
*** PRE-FLOP *** 
MAYOUSSS folds
VivlesBrelan folds
G4NG B4NG raises 300 to 600
Roselie82 folds
manggy94 folds
G4NG B4NG collected 1250 from pot
*** SUMMARY ***
Total pot 1250 | No rake
Seat 5: G4NG B4NG (button) won 1250


Winamax Poker - Tournament "Qualif. Ticket 10€" buyIn: 1.80€ + 0.20€ level: 11 - HandId: #853654187785846786-82-1497874675 - Holdem no limit (40/150/300) - 2017/06/19 12:17:55 UTC
Table: 'Qualif. Ticket 10€(198756854)#001' 6-max (real money) Seat #6 is the button
Seat 1: manggy94 (14372)
Seat 2: MAYOUSSS (4950)
Seat 4: VivlesBrelan (3828)
Seat 5: G4NG B4NG (7145)
Seat 6: Roselie82 (8694)
*** ANTE/BLINDS ***
manggy94 posts ante 40
MAYOUSSS posts ante 40
VivlesBrelan posts ante 40
G4NG B4NG posts ante 40
Roselie82 posts ante 40
manggy94 posts small blind 150
MAYOUSSS posts big blind 300
Dealt to manggy94 [6s Jc]
*** PRE-FLOP *** 
VivlesBrelan folds
G4NG B4NG raises 6805 to 7105 and is all-in
Roselie82 folds
manggy94 folds
MAYOUSSS calls 4610 and is all-in
*** FLOP *** [Ks 7c Ad]
*** TURN *** [Ks 7c Ad][3c]
*** RIVER *** [Ks 7c Ad 3c][5d]
*** SHOW DOWN ***
MAYOUSSS shows [Ah Qc] (One pair : Aces)
G4NG B4NG shows [8d 8s] (One pair : 8)
G4NG B4NG collected 2195 from side pot 1
MAYOUSSS collected 10170 from main pot
*** SUMMARY ***
Total pot 12365 | No rake
Board: [Ks 7c Ad 3c 5d]
Seat 2: MAYOUSSS (big blind) showed [Ah Qc] and won 10170 with One pair : Aces
Seat 5: G4NG B4NG showed [8d 8s] and won 2195 with One pair : 8


Winamax Poker - Tournament "Qualif. Ticket 10€" buyIn: 1.80€ + 0.20€ level: 11 - HandId: #853654187785846786-83-1497874709 - Holdem no limit (40/150/300) - 2017/06/19 12:18:29 UTC
Table: 'Qualif. Ticket 10€(198756854)#001' 6-max (real money) Seat #1 is the button
Seat 1: manggy94 (14182)
Seat 2: MAYOUSSS (10170)
Seat 4: VivlesBrelan (3788)
Seat 5: G4NG B4NG (2195)
Seat 6: Roselie82 (8654)
*** ANTE/BLINDS ***
MAYOUSSS posts ante 40
VivlesBrelan posts ante 40
manggy94 posts ante 40
G4NG B4NG posts ante 40
Roselie82 posts ante 40
MAYOUSSS posts small blind 150
VivlesBrelan posts big blind 300
Dealt to manggy94 [5s Td]
*** PRE-FLOP *** 
G4NG B4NG raises 1855 to 2155 and is all-in
Roselie82 folds
manggy94 folds
MAYOUSSS calls 2005
VivlesBrelan folds
*** FLOP *** [2c Kh Qc]
*** TURN *** [2c Kh Qc][2s]
*** RIVER *** [2c Kh Qc 2s][6d]
*** SHOW DOWN ***
MAYOUSSS shows [4d As] (One pair : 2)
G4NG B4NG shows [Ac Qs] (Two pairs : Queens and 2)
G4NG B4NG collected 4810 from pot
*** SUMMARY ***
Total pot 4810 | No rake
Board: [2c Kh Qc 2s 6d]
Seat 2: MAYOUSSS (small blind) showed [4d As] and lost with One pair : 2
Seat 5: G4NG B4NG showed [Ac Qs] and won 4810 with Two pairs : Queens and 2


Winamax Poker - Tournament "Qualif. Ticket 10€" buyIn: 1.80€ + 0.20€ level: 11 - HandId: #853654187785846786-84-1497874738 - Holdem no limit (40/150/300) - 2017/06/19 12:18:58 UTC
Table: 'Qualif. Ticket 10€(198756854)#001' 6-max (real money) Seat #2 is the button
Seat 1: manggy94 (14142)
Seat 2: MAYOUSSS (7975)
Seat 4: VivlesBrelan (3448)
Seat 5: G4NG B4NG (4810)
Seat 6: Roselie82 (8614)
*** ANTE/BLINDS ***
VivlesBrelan posts ante 40
G4NG B4NG posts ante 40
manggy94 posts ante 40
MAYOUSSS posts ante 40
Roselie82 posts ante 40
VivlesBrelan posts small blind 150
G4NG B4NG posts big blind 300
Dealt to manggy94 [Tc 8c]
*** PRE-FLOP *** 
Roselie82 folds
manggy94 folds
MAYOUSSS folds
VivlesBrelan folds
G4NG B4NG collected 650 from pot
*** SUMMARY ***
Total pot 650 | No rake
Seat 5: G4NG B4NG (big blind) won 650


Winamax Poker - Tournament "Qualif. Ticket 10€" buyIn: 1.80€ + 0.20€ level: 11 - HandId: #853654187785846786-85-1497874761 - Holdem no limit (40/150/300) - 2017/06/19 12:19:21 UTC
Table: 'Qualif. Ticket 10€(198756854)#001' 6-max (real money) Seat #4 is the button
Seat 1: manggy94 (14102)
Seat 2: MAYOUSSS (7935)
Seat 4: VivlesBrelan (3258)
Seat 5: G4NG B4NG (5120)
Seat 6: Roselie82 (8574)
*** ANTE/BLINDS ***
G4NG B4NG posts ante 40
Roselie82 posts ante 40
manggy94 posts ante 40
MAYOUSSS posts ante 40
VivlesBrelan posts ante 40
G4NG B4NG posts small blind 150
Roselie82 posts big blind 300
Dealt to manggy94 [6d 7c]
*** PRE-FLOP *** 
manggy94 folds
MAYOUSSS raises 387 to 687
VivlesBrelan raises 2531 to 3218 and is all-in
G4NG B4NG folds
Roselie82 folds
MAYOUSSS calls 2531
*** FLOP *** [6h 5s As]
*** TURN *** [6h 5s As][6c]
*** RIVER *** [6h 5s As 6c][8s]
*** SHOW DOWN ***
MAYOUSSS shows [Jh Ac] (Two pairs : Aces and 6)
VivlesBrelan shows [Ah Kh] (Two pairs : Aces and 6)
VivlesBrelan collected 7086 from pot
*** SUMMARY ***
Total pot 7086 | No rake
Board: [6h 5s As 6c 8s]
Seat 2: MAYOUSSS showed [Jh Ac] and lost with Two pairs : Aces and 6
Seat 4: VivlesBrelan (button) showed [Ah Kh] and won 7086 with Two pairs : Aces and 6


Winamax Poker - Tournament "Qualif. Ticket 10€" buyIn: 1.80€ + 0.20€ level: 11 - HandId: #853654187785846786-86-1497874790 - Holdem no limit (40/150/300) - 2017/06/19 12:19:50 UTC
Table: 'Qualif. Ticket 10€(198756854)#001' 6-max (real money) Seat #5 is the button
Seat 1: manggy94 (14062)
Seat 2: MAYOUSSS (4677)
Seat 4: VivlesBrelan (7086)
Seat 5: G4NG B4NG (4930)
Seat 6: Roselie82 (8234)
*** ANTE/BLINDS ***
Roselie82 posts ante 40
manggy94 posts ante 40
MAYOUSSS posts ante 40
VivlesBrelan posts ante 40
G4NG B4NG posts ante 40
Roselie82 posts small blind 150
manggy94 posts big blind 300
Dealt to manggy94 [7c 8c]
*** PRE-FLOP *** 
MAYOUSSS folds
VivlesBrelan raises 300 to 600
G4NG B4NG folds
Roselie82 folds
manggy94 calls 300
*** FLOP *** [2c Kh Ts]
manggy94 bets 775
VivlesBrelan folds
manggy94 collected 2325 from pot
*** SUMMARY ***
Total pot 2325 | No rake
Board: [2c Kh Ts]
Seat 1: manggy94 (big blind) won 2325


Winamax Poker - Tournament "Qualif. Ticket 10€" buyIn: 1.80€ + 0.20€ level: 11 - HandId: #853654187785846786-87-1497874813 - Holdem no limit (40/150/300) - 2017/06/19 12:20:13 UTC
Table: 'Qualif. Ticket 10€(198756854)#001' 6-max (real money) Seat #6 is the button
Seat 1: manggy94 (14972)
Seat 2: MAYOUSSS (4637)
Seat 4: VivlesBrelan (6446)
Seat 5: G4NG B4NG (4890)
Seat 6: Roselie82 (8044)
*** ANTE/BLINDS ***
manggy94 posts ante 40
MAYOUSSS posts ante 40
VivlesBrelan posts ante 40
G4NG B4NG posts ante 40
Roselie82 posts ante 40
manggy94 posts small blind 150
MAYOUSSS posts big blind 300
Dealt to manggy94 [4h Kh]
*** PRE-FLOP *** 
VivlesBrelan folds
G4NG B4NG folds
Roselie82 raises 300 to 600
manggy94 folds
MAYOUSSS folds
Roselie82 collected 1250 from pot
*** SUMMARY ***
Total pot 1250 | No rake
Seat 6: Roselie82 (button) won 1250


Winamax Poker - Tournament "Qualif. Ticket 10€" buyIn: 1.80€ + 0.20€ level: 11 - HandId: #853654187785846785-92-1497874842 - Holdem no limit (40/150/300) - 2017/06/19 12:20:42 UTC
Table: 'Qualif. Ticket 10€(198756854)#000' 6-max (real money) Seat #2 is the button
Seat 1: MAYOUSSS (4297)
Seat 2: Tout4Maurice (3958)
Seat 3: thelma14 (3518)
Seat 4: manggy94 (14782)
Seat 5: -jaiminho- (20710)
Seat 6: AAccademiKK (8963)
*** ANTE/BLINDS ***
manggy94 posts ante 40
-jaiminho- posts ante 40
MAYOUSSS posts ante 40
AAccademiKK posts ante 40
manggy94 posts small blind 150
-jaiminho- posts big blind 300
Dealt to manggy94 [Qd Ac]
*** PRE-FLOP *** 
AAccademiKK folds
MAYOUSSS folds
manggy94 raises 300 to 600
-jaiminho- folds
manggy94 collected 1060 from pot
*** SUMMARY ***
Total pot 1060 | No rake
Seat 4: manggy94 (small blind) won 1060


Winamax Poker - Tournament "Qualif. Ticket 10€" buyIn: 1.80€ + 0.20€ level: 12 - HandId: #853654187785846785-93-1497874879 - Holdem no limit (50/200/400) - 2017/06/19 12:21:19 UTC
Table: 'Qualif. Ticket 10€(198756854)#000' 6-max (real money) Seat #4 is the button
Seat 1: MAYOUSSS (4257)
Seat 2: Tout4Maurice (3958)
Seat 3: thelma14 (3518)
Seat 4: manggy94 (15202)
Seat 5: -jaiminho- (20370)
Seat 6: AAccademiKK (8923)
*** ANTE/BLINDS ***
-jaiminho- posts ante 50
AAccademiKK posts ante 50
MAYOUSSS posts ante 50
Tout4Maurice posts ante 50
thelma14 posts ante 50
manggy94 posts ante 50
-jaiminho- posts small blind 200
AAccademiKK posts big blind 400
Dealt to manggy94 [7d 7c]
*** PRE-FLOP *** 
MAYOUSSS folds
Tout4Maurice folds
thelma14 calls 400
manggy94 raises 400 to 800
-jaiminho- calls 600
AAccademiKK folds
thelma14 calls 400
*** FLOP *** [9h Js 8c]
-jaiminho- bets 750
thelma14 raises 1918 to 2668 and is all-in
manggy94 folds
-jaiminho- calls 1918
*** TURN *** [9h Js 8c][2d]
*** RIVER *** [9h Js 8c 2d][Jh]
*** SHOW DOWN ***
thelma14 shows [Qc 9c] (Two pairs : Jacks and 9)
-jaiminho- shows [Jd Kd] (Trips of Jacks)
-jaiminho- collected 8436 from pot
*** SUMMARY ***
Total pot 8436 | No rake
Board: [9h Js 8c 2d Jh]
Seat 3: thelma14 showed [Qc 9c] and lost with Two pairs : Jacks and 9
Seat 5: -jaiminho- (small blind) showed [Jd Kd] and won 8436 with Trips of Jacks


Winamax Poker - Tournament "Qualif. Ticket 10€" buyIn: 1.80€ + 0.20€ level: 12 - HandId: #853654187785846785-94-1497874976 - Holdem no limit (50/200/400) - 2017/06/19 12:22:56 UTC
Table: 'Qualif. Ticket 10€(198756854)#000' 6-max (real money) Seat #5 is the button
Seat 1: MAYOUSSS (4207)
Seat 2: Tout4Maurice (3908)
Seat 4: manggy94 (14352)
Seat 5: -jaiminho- (25288)
Seat 6: AAccademiKK (8473)
*** ANTE/BLINDS ***
AAccademiKK posts ante 50
MAYOUSSS posts ante 50
Tout4Maurice posts ante 50
manggy94 posts ante 50
-jaiminho- posts ante 50
AAccademiKK posts small blind 200
MAYOUSSS posts big blind 400
Dealt to manggy94 [6d 5h]
*** PRE-FLOP *** 
Tout4Maurice folds
manggy94 folds
-jaiminho- raises 400 to 800
AAccademiKK folds
MAYOUSSS folds
-jaiminho- collected 1650 from pot
*** SUMMARY ***
Total pot 1650 | No rake
Seat 5: -jaiminho- (button) won 1650


Winamax Poker - Tournament "Qualif. Ticket 10€" buyIn: 1.80€ + 0.20€ level: 12 - HandId: #853654187785846785-95-1497874999 - Holdem no limit (50/200/400) - 2017/06/19 12:23:19 UTC
Table: 'Qualif. Ticket 10€(198756854)#000' 6-max (real money) Seat #6 is the button
Seat 1: MAYOUSSS (3757)
Seat 2: Tout4Maurice (3858)
Seat 4: manggy94 (14302)
Seat 5: -jaiminho- (26088)
Seat 6: AAccademiKK (8223)
*** ANTE/BLINDS ***
MAYOUSSS posts ante 50
Tout4Maurice posts ante 50
manggy94 posts ante 50
-jaiminho- posts ante 50
AAccademiKK posts ante 50
MAYOUSSS posts small blind 200
Tout4Maurice posts big blind 400
Dealt to manggy94 [3h 7c]
*** PRE-FLOP *** 
manggy94 folds
-jaiminho- raises 400 to 800
AAccademiKK folds
MAYOUSSS raises 2907 to 3707 and is all-in
Tout4Maurice folds
-jaiminho- folds
MAYOUSSS collected 5157 from pot
*** SUMMARY ***
Total pot 5157 | No rake
Seat 1: MAYOUSSS (small blind) won 5157


Winamax Poker - Tournament "Qualif. Ticket 10€" buyIn: 1.80€ + 0.20€ level: 12 - HandId: #853654187785846785-96-1497875020 - Holdem no limit (50/200/400) - 2017/06/19 12:23:40 UTC
Table: 'Qualif. Ticket 10€(198756854)#000' 6-max (real money) Seat #1 is the button
Seat 1: MAYOUSSS (5157)
Seat 2: Tout4Maurice (3408)
Seat 4: manggy94 (14252)
Seat 5: -jaiminho- (25238)
Seat 6: AAccademiKK (8173)
*** ANTE/BLINDS ***
Tout4Maurice posts ante 50
manggy94 posts ante 50
MAYOUSSS posts ante 50
-jaiminho- posts ante 50
AAccademiKK posts ante 50
Tout4Maurice posts small blind 200
manggy94 posts big blind 400
Dealt to manggy94 [3s 6s]
*** PRE-FLOP *** 
-jaiminho- folds
AAccademiKK folds
MAYOUSSS raises 516 to 916
Tout4Maurice folds
manggy94 folds
MAYOUSSS collected 1766 from pot
*** SUMMARY ***
Total pot 1766 | No rake
Seat 1: MAYOUSSS (button) won 1766


Winamax Poker - Tournament "Qualif. Ticket 10€" buyIn: 1.80€ + 0.20€ level: 12 - HandId: #853654187785846785-97-1497875052 - Holdem no limit (50/200/400) - 2017/06/19 12:24:12 UTC
Table: 'Qualif. Ticket 10€(198756854)#000' 6-max (real money) Seat #2 is the button
Seat 1: MAYOUSSS (5957)
Seat 2: Tout4Maurice (3158)
Seat 4: manggy94 (13802)
Seat 5: -jaiminho- (25188)
Seat 6: AAccademiKK (8123)
*** ANTE/BLINDS ***
manggy94 posts ante 50
-jaiminho- posts ante 50
MAYOUSSS posts ante 50
Tout4Maurice posts ante 50
AAccademiKK posts ante 50
manggy94 posts small blind 200
-jaiminho- posts big blind 400
Dealt to manggy94 [Kc 2s]
*** PRE-FLOP *** 
AAccademiKK raises 600 to 1000
MAYOUSSS folds
Tout4Maurice raises 2108 to 3108 and is all-in
manggy94 folds
-jaiminho- folds
AAccademiKK folds
Tout4Maurice collected 4958 from pot
*** SUMMARY ***
Total pot 4958 | No rake
Seat 2: Tout4Maurice (button) won 4958


Winamax Poker - Tournament "Qualif. Ticket 10€" buyIn: 1.80€ + 0.20€ level: 12 - HandId: #853654187785846785-98-1497875100 - Holdem no limit (50/200/400) - 2017/06/19 12:25:00 UTC
Table: 'Qualif. Ticket 10€(198756854)#000' 6-max (real money) Seat #4 is the button
Seat 1: MAYOUSSS (5907)
Seat 2: Tout4Maurice (4958)
Seat 4: manggy94 (13552)
Seat 5: -jaiminho- (24738)
Seat 6: AAccademiKK (7073)
*** ANTE/BLINDS ***
-jaiminho- posts ante 50
AAccademiKK posts ante 50
MAYOUSSS posts ante 50
Tout4Maurice posts ante 50
manggy94 posts ante 50
-jaiminho- posts small blind 200
AAccademiKK posts big blind 400
Dealt to manggy94 [7c 6c]
*** PRE-FLOP *** 
MAYOUSSS folds
Tout4Maurice folds
manggy94 calls 400
-jaiminho- calls 200
AAccademiKK checks
*** FLOP *** [5d 4d 3h]
-jaiminho- checks
AAccademiKK checks
manggy94 bets 400
-jaiminho- folds
AAccademiKK folds
manggy94 collected 1850 from pot
*** SUMMARY ***
Total pot 1850 | No rake
Board: [5d 4d 3h]
Seat 4: manggy94 (button) won 1850


Winamax Poker - Tournament "Qualif. Ticket 10€" buyIn: 1.80€ + 0.20€ level: 12 - HandId: #853654187785846785-99-1497875135 - Holdem no limit (50/200/400) - 2017/06/19 12:25:35 UTC
Table: 'Qualif. Ticket 10€(198756854)#000' 6-max (real money) Seat #5 is the button
Seat 1: MAYOUSSS (5857)
Seat 2: Tout4Maurice (4908)
Seat 4: manggy94 (14552)
Seat 5: -jaiminho- (24288)
Seat 6: AAccademiKK (6623)
*** ANTE/BLINDS ***
AAccademiKK posts ante 50
MAYOUSSS posts ante 50
Tout4Maurice posts ante 50
manggy94 posts ante 50
-jaiminho- posts ante 50
AAccademiKK posts small blind 200
MAYOUSSS posts big blind 400
Dealt to manggy94 [9c 2c]
*** PRE-FLOP *** 
Tout4Maurice folds
manggy94 folds
-jaiminho- calls 400
AAccademiKK folds
MAYOUSSS checks
*** FLOP *** [6d 2s Th]
MAYOUSSS checks
-jaiminho- bets 400
MAYOUSSS folds
-jaiminho- collected 1650 from pot
*** SUMMARY ***
Total pot 1650 | No rake
Board: [6d 2s Th]
Seat 5: -jaiminho- (button) won 1650


Winamax Poker - Tournament "Qualif. Ticket 10€" buyIn: 1.80€ + 0.20€ level: 12 - HandId: #853654187785846785-100-1497875155 - Holdem no limit (50/200/400) - 2017/06/19 12:25:55 UTC
Table: 'Qualif. Ticket 10€(198756854)#000' 6-max (real money) Seat #6 is the button
Seat 1: MAYOUSSS (5407)
Seat 2: Tout4Maurice (4858)
Seat 4: manggy94 (14502)
Seat 5: -jaiminho- (25088)
Seat 6: AAccademiKK (6373)
*** ANTE/BLINDS ***
MAYOUSSS posts ante 50
Tout4Maurice posts ante 50
manggy94 posts ante 50
-jaiminho- posts ante 50
AAccademiKK posts ante 50
MAYOUSSS posts small blind 200
Tout4Maurice posts big blind 400
Dealt to manggy94 [Kh 2h]
*** PRE-FLOP *** 
manggy94 folds
-jaiminho- calls 400
AAccademiKK folds
MAYOUSSS folds
Tout4Maurice checks
*** FLOP *** [Ah 3d 8c]
Tout4Maurice checks
-jaiminho- bets 600
Tout4Maurice calls 600
*** TURN *** [Ah 3d 8c][7s]
Tout4Maurice bets 1600
-jaiminho- folds
Tout4Maurice collected 4050 from pot
*** SUMMARY ***
Total pot 4050 | No rake
Board: [Ah 3d 8c 7s]
Seat 2: Tout4Maurice (big blind) won 4050


Winamax Poker - Tournament "Qualif. Ticket 10€" buyIn: 1.80€ + 0.20€ level: 12 - HandId: #853654187785846785-101-1497875191 - Holdem no limit (50/200/400) - 2017/06/19 12:26:31 UTC
Table: 'Qualif. Ticket 10€(198756854)#000' 6-max (real money) Seat #1 is the button
Seat 1: MAYOUSSS (5157)
Seat 2: Tout4Maurice (6258)
Seat 4: manggy94 (14452)
Seat 5: -jaiminho- (24038)
Seat 6: AAccademiKK (6323)
*** ANTE/BLINDS ***
Tout4Maurice posts ante 50
manggy94 posts ante 50
MAYOUSSS posts ante 50
-jaiminho- posts ante 50
AAccademiKK posts ante 50
Tout4Maurice posts small blind 200
manggy94 posts big blind 400
Dealt to manggy94 [Qc Js]
*** PRE-FLOP *** 
-jaiminho- folds
AAccademiKK raises 600 to 1000
MAYOUSSS folds
Tout4Maurice folds
manggy94 calls 600
*** FLOP *** [Ah 5c 9h]
manggy94 checks
AAccademiKK bets 1225
manggy94 raises 1225 to 2450
AAccademiKK folds
manggy94 collected 6125 from pot
*** SUMMARY ***
Total pot 6125 | No rake
Board: [Ah 5c 9h]
Seat 4: manggy94 (big blind) won 6125


Winamax Poker - Tournament "Qualif. Ticket 10€" buyIn: 1.80€ + 0.20€ level: 13 - HandId: #853654187785846785-102-1497875230 - Holdem no limit (60/250/500) - 2017/06/19 12:27:10 UTC
Table: 'Qualif. Ticket 10€(198756854)#000' 6-max (real money) Seat #2 is the button
Seat 1: MAYOUSSS (5107)
Seat 2: Tout4Maurice (6008)
Seat 4: manggy94 (17077)
Seat 5: -jaiminho- (23988)
Seat 6: AAccademiKK (4048)
*** ANTE/BLINDS ***
manggy94 posts ante 60
-jaiminho- posts ante 60
MAYOUSSS posts ante 60
Tout4Maurice posts ante 60
AAccademiKK posts ante 60
manggy94 posts small blind 250
-jaiminho- posts big blind 500
Dealt to manggy94 [3h Js]
*** PRE-FLOP *** 
AAccademiKK folds
MAYOUSSS raises 4547 to 5047 and is all-in
Tout4Maurice folds
manggy94 folds
-jaiminho- folds
MAYOUSSS collected 6097 from pot
*** SUMMARY ***
Total pot 6097 | No rake
Seat 1: MAYOUSSS won 6097


Winamax Poker - Tournament "Qualif. Ticket 10€" buyIn: 1.80€ + 0.20€ level: 13 - HandId: #853654187785846785-103-1497875249 - Holdem no limit (60/250/500) - 2017/06/19 12:27:29 UTC
Table: 'Qualif. Ticket 10€(198756854)#000' 6-max (real money) Seat #4 is the button
Seat 1: MAYOUSSS (6097)
Seat 2: Tout4Maurice (5948)
Seat 4: manggy94 (16767)
Seat 5: -jaiminho- (23428)
Seat 6: AAccademiKK (3988)
*** ANTE/BLINDS ***
-jaiminho- posts ante 60
AAccademiKK posts ante 60
MAYOUSSS posts ante 60
Tout4Maurice posts ante 60
manggy94 posts ante 60
-jaiminho- posts small blind 250
AAccademiKK posts big blind 500
Dealt to manggy94 [Qs 9s]
*** PRE-FLOP *** 
MAYOUSSS folds
Tout4Maurice folds
manggy94 calls 500
-jaiminho- calls 250
AAccademiKK checks
*** FLOP *** [Td 6c Js]
-jaiminho- checks
AAccademiKK checks
manggy94 bets 900
-jaiminho- folds
AAccademiKK folds
manggy94 collected 2700 from pot
*** SUMMARY ***
Total pot 2700 | No rake
Board: [Td 6c Js]
Seat 4: manggy94 (button) won 2700


Winamax Poker - Tournament "Qualif. Ticket 10€" buyIn: 1.80€ + 0.20€ level: 13 - HandId: #853654187785846785-104-1497875281 - Holdem no limit (60/250/500) - 2017/06/19 12:28:01 UTC
Table: 'Qualif. Ticket 10€(198756854)#000' 6-max (real money) Seat #5 is the button
Seat 1: MAYOUSSS (6037)
Seat 2: Tout4Maurice (5888)
Seat 4: manggy94 (18007)
Seat 5: -jaiminho- (22868)
Seat 6: AAccademiKK (3428)
*** ANTE/BLINDS ***
AAccademiKK posts ante 60
MAYOUSSS posts ante 60
Tout4Maurice posts ante 60
manggy94 posts ante 60
-jaiminho- posts ante 60
AAccademiKK posts small blind 250
MAYOUSSS posts big blind 500
Dealt to manggy94 [Qh As]
*** PRE-FLOP *** 
Tout4Maurice folds
manggy94 raises 1000 to 1500
-jaiminho- folds
AAccademiKK folds
MAYOUSSS folds
manggy94 collected 2550 from pot
*** SUMMARY ***
Total pot 2550 | No rake
Seat 4: manggy94 won 2550


Winamax Poker - Tournament "Qualif. Ticket 10€" buyIn: 1.80€ + 0.20€ level: 13 - HandId: #853654187785846785-105-1497875293 - Holdem no limit (60/250/500) - 2017/06/19 12:28:13 UTC
Table: 'Qualif. Ticket 10€(198756854)#000' 6-max (real money) Seat #6 is the button
Seat 1: MAYOUSSS (5477)
Seat 2: Tout4Maurice (5828)
Seat 4: manggy94 (18997)
Seat 5: -jaiminho- (22808)
Seat 6: AAccademiKK (3118)
*** ANTE/BLINDS ***
MAYOUSSS posts ante 60
Tout4Maurice posts ante 60
manggy94 posts ante 60
-jaiminho- posts ante 60
AAccademiKK posts ante 60
MAYOUSSS posts small blind 250
Tout4Maurice posts big blind 500
Dealt to manggy94 [Qd 4d]
*** PRE-FLOP *** 
manggy94 folds
-jaiminho- folds
AAccademiKK raises 2558 to 3058 and is all-in
MAYOUSSS folds
Tout4Maurice folds
AAccademiKK collected 4108 from pot
*** SUMMARY ***
Total pot 4108 | No rake
Seat 6: AAccademiKK (button) won 4108


Winamax Poker - Tournament "Qualif. Ticket 10€" buyIn: 1.80€ + 0.20€ level: 13 - HandId: #853654187785846785-106-1497875316 - Holdem no limit (60/250/500) - 2017/06/19 12:28:36 UTC
Table: 'Qualif. Ticket 10€(198756854)#000' 6-max (real money) Seat #1 is the button
Seat 1: MAYOUSSS (5167)
Seat 2: Tout4Maurice (5268)
Seat 4: manggy94 (18937)
Seat 5: -jaiminho- (22748)
Seat 6: AAccademiKK (4108)
*** ANTE/BLINDS ***
Tout4Maurice posts ante 60
manggy94 posts ante 60
MAYOUSSS posts ante 60
-jaiminho- posts ante 60
AAccademiKK posts ante 60
Tout4Maurice posts small blind 250
manggy94 posts big blind 500
Dealt to manggy94 [5h 7s]
*** PRE-FLOP *** 
-jaiminho- folds
AAccademiKK folds
MAYOUSSS raises 645 to 1145
Tout4Maurice folds
manggy94 folds
MAYOUSSS collected 2195 from pot
*** SUMMARY ***
Total pot 2195 | No rake
Seat 1: MAYOUSSS (button) won 2195


Winamax Poker - Tournament "Qualif. Ticket 10€" buyIn: 1.80€ + 0.20€ level: 13 - HandId: #853654187785846785-107-1497875330 - Holdem no limit (60/250/500) - 2017/06/19 12:28:50 UTC
Table: 'Qualif. Ticket 10€(198756854)#000' 6-max (real money) Seat #2 is the button
Seat 1: MAYOUSSS (6157)
Seat 2: Tout4Maurice (4958)
Seat 4: manggy94 (18377)
Seat 5: -jaiminho- (22688)
Seat 6: AAccademiKK (4048)
*** ANTE/BLINDS ***
manggy94 posts ante 60
-jaiminho- posts ante 60
MAYOUSSS posts ante 60
Tout4Maurice posts ante 60
AAccademiKK posts ante 60
manggy94 posts small blind 250
-jaiminho- posts big blind 500
Dealt to manggy94 [2h 6h]
*** PRE-FLOP *** 
AAccademiKK folds
MAYOUSSS folds
Tout4Maurice folds
manggy94 folds
-jaiminho- collected 1050 from pot
*** SUMMARY ***
Total pot 1050 | No rake
Seat 5: -jaiminho- (big blind) won 1050


Winamax Poker - Tournament "Qualif. Ticket 10€" buyIn: 1.80€ + 0.20€ level: 13 - HandId: #853654187785846785-108-1497875342 - Holdem no limit (60/250/500) - 2017/06/19 12:29:02 UTC
Table: 'Qualif. Ticket 10€(198756854)#000' 6-max (real money) Seat #4 is the button
Seat 1: MAYOUSSS (6097)
Seat 2: Tout4Maurice (4898)
Seat 4: manggy94 (18067)
Seat 5: -jaiminho- (23178)
Seat 6: AAccademiKK (3988)
*** ANTE/BLINDS ***
-jaiminho- posts ante 60
AAccademiKK posts ante 60
MAYOUSSS posts ante 60
Tout4Maurice posts ante 60
manggy94 posts ante 60
-jaiminho- posts small blind 250
AAccademiKK posts big blind 500
Dealt to manggy94 [8d Jd]
*** PRE-FLOP *** 
MAYOUSSS folds
Tout4Maurice folds
manggy94 raises 500 to 1000
-jaiminho- folds
AAccademiKK folds
manggy94 collected 2050 from pot
*** SUMMARY ***
Total pot 2050 | No rake
Seat 4: manggy94 (button) won 2050


Winamax Poker - Tournament "Qualif. Ticket 10€" buyIn: 1.80€ + 0.20€ level: 13 - HandId: #853654187785846785-109-1497875376 - Holdem no limit (60/250/500) - 2017/06/19 12:29:36 UTC
Table: 'Qualif. Ticket 10€(198756854)#000' 6-max (real money) Seat #5 is the button
Seat 1: MAYOUSSS (6037)
Seat 2: Tout4Maurice (4838)
Seat 4: manggy94 (19057)
Seat 5: -jaiminho- (22868)
Seat 6: AAccademiKK (3428)
*** ANTE/BLINDS ***
AAccademiKK posts ante 60
MAYOUSSS posts ante 60
Tout4Maurice posts ante 60
manggy94 posts ante 60
-jaiminho- posts ante 60
AAccademiKK posts small blind 250
MAYOUSSS posts big blind 500
Dealt to manggy94 [5h 2c]
*** PRE-FLOP *** 
Tout4Maurice folds
manggy94 folds
-jaiminho- folds
AAccademiKK folds
MAYOUSSS collected 1050 from pot
*** SUMMARY ***
Total pot 1050 | No rake
Seat 1: MAYOUSSS (big blind) won 1050


Winamax Poker - Tournament "Qualif. Ticket 10€" buyIn: 1.80€ + 0.20€ level: 13 - HandId: #853654187785846785-110-1497875407 - Holdem no limit (60/250/500) - 2017/06/19 12:30:07 UTC
Table: 'Qualif. Ticket 10€(198756854)#000' 6-max (real money) Seat #6 is the button
Seat 1: MAYOUSSS (6527)
Seat 2: Tout4Maurice (4778)
Seat 4: manggy94 (18997)
Seat 5: -jaiminho- (22808)
Seat 6: AAccademiKK (3118)
*** ANTE/BLINDS ***
MAYOUSSS posts ante 60
Tout4Maurice posts ante 60
manggy94 posts ante 60
-jaiminho- posts ante 60
AAccademiKK posts ante 60
MAYOUSSS posts small blind 250
Tout4Maurice posts big blind 500
Dealt to manggy94 [9s 6d]
*** PRE-FLOP *** 
manggy94 folds
-jaiminho- folds
AAccademiKK folds
MAYOUSSS folds
Tout4Maurice collected 1050 from pot
*** SUMMARY ***
Total pot 1050 | No rake
Seat 2: Tout4Maurice (big blind) won 1050


Winamax Poker - Tournament "Qualif. Ticket 10€" buyIn: 1.80€ + 0.20€ level: 13 - HandId: #853654187785846785-111-1497875424 - Holdem no limit (60/250/500) - 2017/06/19 12:30:24 UTC
Table: 'Qualif. Ticket 10€(198756854)#000' 6-max (real money) Seat #1 is the button
Seat 1: MAYOUSSS (6217)
Seat 2: Tout4Maurice (5268)
Seat 4: manggy94 (18937)
Seat 5: -jaiminho- (22748)
Seat 6: AAccademiKK (3058)
*** ANTE/BLINDS ***
Tout4Maurice posts ante 60
manggy94 posts ante 60
MAYOUSSS posts ante 60
-jaiminho- posts ante 60
AAccademiKK posts ante 60
Tout4Maurice posts small blind 250
manggy94 posts big blind 500
Dealt to manggy94 [Jc 5h]
*** PRE-FLOP *** 
-jaiminho- folds
AAccademiKK folds
MAYOUSSS folds
Tout4Maurice folds
manggy94 collected 1050 from pot
*** SUMMARY ***
Total pot 1050 | No rake
Seat 4: manggy94 (big blind) won 1050


Winamax Poker - Tournament "Qualif. Ticket 10€" buyIn: 1.80€ + 0.20€ level: 13 - HandId: #853654187785846785-112-1497875443 - Holdem no limit (60/250/500) - 2017/06/19 12:30:43 UTC
Table: 'Qualif. Ticket 10€(198756854)#000' 6-max (real money) Seat #2 is the button
Seat 1: MAYOUSSS (6157)
Seat 2: Tout4Maurice (4958)
Seat 4: manggy94 (19427)
Seat 5: -jaiminho- (22688)
Seat 6: AAccademiKK (2998)
*** ANTE/BLINDS ***
manggy94 posts ante 60
-jaiminho- posts ante 60
MAYOUSSS posts ante 60
Tout4Maurice posts ante 60
AAccademiKK posts ante 60
manggy94 posts small blind 250
-jaiminho- posts big blind 500
Dealt to manggy94 [7d Ah]
*** PRE-FLOP *** 
AAccademiKK folds
MAYOUSSS raises 645 to 1145
Tout4Maurice folds
manggy94 folds
-jaiminho- folds
MAYOUSSS collected 2195 from pot
*** SUMMARY ***
Total pot 2195 | No rake
Seat 1: MAYOUSSS won 2195


Winamax Poker - Tournament "Qualif. Ticket 10€" buyIn: 1.80€ + 0.20€ level: 13 - HandId: #853654187785846785-113-1497875476 - Holdem no limit (60/250/500) - 2017/06/19 12:31:16 UTC
Table: 'Qualif. Ticket 10€(198756854)#000' 6-max (real money) Seat #4 is the button
Seat 1: MAYOUSSS (7147)
Seat 2: Tout4Maurice (4898)
Seat 4: manggy94 (19117)
Seat 5: -jaiminho- (22128)
Seat 6: AAccademiKK (2938)
*** ANTE/BLINDS ***
-jaiminho- posts ante 60
AAccademiKK posts ante 60
MAYOUSSS posts ante 60
Tout4Maurice posts ante 60
manggy94 posts ante 60
-jaiminho- posts small blind 250
AAccademiKK posts big blind 500
Dealt to manggy94 [Ad Qs]
*** PRE-FLOP *** 
MAYOUSSS folds
Tout4Maurice raises 4338 to 4838 and is all-in
manggy94 calls 4838
-jaiminho- folds
AAccademiKK folds
*** FLOP *** [7c 4d 4h]
*** TURN *** [7c 4d 4h][8s]
*** RIVER *** [7c 4d 4h 8s][5s]
*** SHOW DOWN ***
manggy94 shows [Ad Qs] (One pair : 4)
Tout4Maurice shows [As 7d] (Two pairs : 7 and 4)
Tout4Maurice collected 10726 from pot
*** SUMMARY ***
Total pot 10726 | No rake
Board: [7c 4d 4h 8s 5s]
Seat 2: Tout4Maurice showed [As 7d] and won 10726 with Two pairs : 7 and 4
Seat 4: manggy94 (button) showed [Ad Qs] and lost with One pair : 4


Winamax Poker - Tournament "Qualif. Ticket 10€" buyIn: 1.80€ + 0.20€ level: 13 - HandId: #853654187785846785-114-1497875495 - Holdem no limit (60/250/500) - 2017/06/19 12:31:35 UTC
Table: 'Qualif. Ticket 10€(198756854)#000' 6-max (real money) Seat #5 is the button
Seat 1: MAYOUSSS (7087)
Seat 2: Tout4Maurice (10726)
Seat 4: manggy94 (14219)
Seat 5: -jaiminho- (21818)
Seat 6: AAccademiKK (2378)
*** ANTE/BLINDS ***
AAccademiKK posts ante 60
MAYOUSSS posts ante 60
Tout4Maurice posts ante 60
manggy94 posts ante 60
-jaiminho- posts ante 60
AAccademiKK posts small blind 250
MAYOUSSS posts big blind 500
Dealt to manggy94 [9c 8h]
*** PRE-FLOP *** 
Tout4Maurice folds
manggy94 folds
-jaiminho- folds
AAccademiKK raises 1818 to 2318 and is all-in
MAYOUSSS calls 1818
*** FLOP *** [As 3d Ad]
*** TURN *** [As 3d Ad][2c]
*** RIVER *** [As 3d Ad 2c][Ac]
*** SHOW DOWN ***
MAYOUSSS shows [Qd Ts] (Trips of Aces)
AAccademiKK shows [9h 9s] (Full of Aces and 9)
AAccademiKK collected 4936 from pot
*** SUMMARY ***
Total pot 4936 | No rake
Board: [As 3d Ad 2c Ac]
Seat 1: MAYOUSSS (big blind) showed [Qd Ts] and lost with Trips of Aces
Seat 6: AAccademiKK (small blind) showed [9h 9s] and won 4936 with Full of Aces and 9


Winamax Poker - Tournament "Qualif. Ticket 10€" buyIn: 1.80€ + 0.20€ level: 13 - HandId: #853654187785846785-115-1497875524 - Holdem no limit (60/250/500) - 2017/06/19 12:32:04 UTC
Table: 'Qualif. Ticket 10€(198756854)#000' 6-max (real money) Seat #6 is the button
Seat 1: MAYOUSSS (4709)
Seat 2: Tout4Maurice (10666)
Seat 4: manggy94 (14159)
Seat 5: -jaiminho- (21758)
Seat 6: AAccademiKK (4936)
*** ANTE/BLINDS ***
MAYOUSSS posts ante 60
Tout4Maurice posts ante 60
manggy94 posts ante 60
-jaiminho- posts ante 60
AAccademiKK posts ante 60
MAYOUSSS posts small blind 250
Tout4Maurice posts big blind 500
Dealt to manggy94 [Qc Ks]
*** PRE-FLOP *** 
manggy94 calls 500
-jaiminho- folds
AAccademiKK folds
MAYOUSSS calls 250
Tout4Maurice checks
*** FLOP *** [4s Ad Js]
MAYOUSSS checks
Tout4Maurice checks
manggy94 checks
*** TURN *** [4s Ad Js][Ah]
MAYOUSSS checks
Tout4Maurice checks
manggy94 bets 500
MAYOUSSS folds
Tout4Maurice folds
manggy94 collected 2300 from pot
*** SUMMARY ***
Total pot 2300 | No rake
Board: [4s Ad Js Ah]
Seat 4: manggy94 won 2300


Winamax Poker - Tournament "Qualif. Ticket 10€" buyIn: 1.80€ + 0.20€ level: 13 - HandId: #853654187785846785-116-1497875563 - Holdem no limit (60/250/500) - 2017/06/19 12:32:43 UTC
Table: 'Qualif. Ticket 10€(198756854)#000' 6-max (real money) Seat #1 is the button
Seat 1: MAYOUSSS (4149)
Seat 2: Tout4Maurice (10106)
Seat 4: manggy94 (15399)
Seat 5: -jaiminho- (21698)
Seat 6: AAccademiKK (4876)
*** ANTE/BLINDS ***
Tout4Maurice posts ante 60
manggy94 posts ante 60
MAYOUSSS posts ante 60
-jaiminho- posts ante 60
AAccademiKK posts ante 60
Tout4Maurice posts small blind 250
manggy94 posts big blind 500
Dealt to manggy94 [Ah 7c]
*** PRE-FLOP *** 
-jaiminho- folds
AAccademiKK folds
MAYOUSSS raises 3589 to 4089 and is all-in
Tout4Maurice folds
manggy94 calls 3589
*** FLOP *** [4h Qc 2s]
*** TURN *** [4h Qc 2s][8s]
*** RIVER *** [4h Qc 2s 8s][Th]
*** SHOW DOWN ***
manggy94 shows [Ah 7c] (High card : Ace)
MAYOUSSS shows [4d Jd] (One pair : 4)
MAYOUSSS collected 8728 from pot
*** SUMMARY ***
Total pot 8728 | No rake
Board: [4h Qc 2s 8s Th]
Seat 1: MAYOUSSS (button) showed [4d Jd] and won 8728 with One pair : 4
Seat 4: manggy94 (big blind) showed [Ah 7c] and lost with High card : Ace


Winamax Poker - Tournament "Qualif. Ticket 10€" buyIn: 1.80€ + 0.20€ level: 14 - HandId: #853654187785846785-117-1497875606 - Holdem no limit (80/300/600) - 2017/06/19 12:33:26 UTC
Table: 'Qualif. Ticket 10€(198756854)#000' 6-max (real money) Seat #2 is the button
Seat 1: MAYOUSSS (8728)
Seat 2: Tout4Maurice (9796)
Seat 4: manggy94 (11250)
Seat 5: -jaiminho- (21638)
Seat 6: AAccademiKK (4816)
*** ANTE/BLINDS ***
manggy94 posts ante 80
-jaiminho- posts ante 80
MAYOUSSS posts ante 80
Tout4Maurice posts ante 80
AAccademiKK posts ante 80
manggy94 posts small blind 300
-jaiminho- posts big blind 600
Dealt to manggy94 [Qc 3s]
*** PRE-FLOP *** 
AAccademiKK folds
MAYOUSSS folds
Tout4Maurice folds
manggy94 folds
-jaiminho- collected 1300 from pot
*** SUMMARY ***
Total pot 1300 | No rake
Seat 5: -jaiminho- (big blind) won 1300


Winamax Poker - Tournament "Qualif. Ticket 10€" buyIn: 1.80€ + 0.20€ level: 14 - HandId: #853654187785846785-118-1497875621 - Holdem no limit (80/300/600) - 2017/06/19 12:33:41 UTC
Table: 'Qualif. Ticket 10€(198756854)#000' 6-max (real money) Seat #4 is the button
Seat 1: MAYOUSSS (8648)
Seat 2: Tout4Maurice (9716)
Seat 4: manggy94 (10870)
Seat 5: -jaiminho- (22258)
Seat 6: AAccademiKK (4736)
*** ANTE/BLINDS ***
-jaiminho- posts ante 80
AAccademiKK posts ante 80
MAYOUSSS posts ante 80
Tout4Maurice posts ante 80
manggy94 posts ante 80
-jaiminho- posts small blind 300
AAccademiKK posts big blind 600
Dealt to manggy94 [Qh 8s]
*** PRE-FLOP *** 
MAYOUSSS folds
Tout4Maurice folds
manggy94 folds
-jaiminho- raises 21578 to 22178 and is all-in
AAccademiKK folds
-jaiminho- collected 23178 from pot
*** SUMMARY ***
Total pot 23178 | No rake
Seat 5: -jaiminho- (small blind) won 23178


Winamax Poker - Tournament "Qualif. Ticket 10€" buyIn: 1.80€ + 0.20€ level: 14 - HandId: #853654187785846785-119-1497875647 - Holdem no limit (80/300/600) - 2017/06/19 12:34:07 UTC
Table: 'Qualif. Ticket 10€(198756854)#000' 6-max (real money) Seat #5 is the button
Seat 1: MAYOUSSS (8568)
Seat 2: Tout4Maurice (9636)
Seat 4: manggy94 (10790)
Seat 5: -jaiminho- (23178)
Seat 6: AAccademiKK (4056)
*** ANTE/BLINDS ***
AAccademiKK posts ante 80
MAYOUSSS posts ante 80
Tout4Maurice posts ante 80
manggy94 posts ante 80
-jaiminho- posts ante 80
AAccademiKK posts small blind 300
MAYOUSSS posts big blind 600
Dealt to manggy94 [7c Th]
*** PRE-FLOP *** 
Tout4Maurice folds
manggy94 folds
-jaiminho- folds
AAccademiKK raises 3376 to 3976 and is all-in
MAYOUSSS folds
AAccademiKK collected 4976 from pot
*** SUMMARY ***
Total pot 4976 | No rake
Seat 6: AAccademiKK (small blind) won 4976


Winamax Poker - Tournament "Qualif. Ticket 10€" buyIn: 1.80€ + 0.20€ level: 14 - HandId: #853654187785846785-120-1497875661 - Holdem no limit (80/300/600) - 2017/06/19 12:34:21 UTC
Table: 'Qualif. Ticket 10€(198756854)#000' 6-max (real money) Seat #6 is the button
Seat 1: MAYOUSSS (7888)
Seat 2: Tout4Maurice (9556)
Seat 4: manggy94 (10710)
Seat 5: -jaiminho- (23098)
Seat 6: AAccademiKK (4976)
*** ANTE/BLINDS ***
MAYOUSSS posts ante 80
Tout4Maurice posts ante 80
manggy94 posts ante 80
-jaiminho- posts ante 80
AAccademiKK posts ante 80
MAYOUSSS posts small blind 300
Tout4Maurice posts big blind 600
Dealt to manggy94 [2c Qs]
*** PRE-FLOP *** 
manggy94 folds
-jaiminho- folds
AAccademiKK raises 4296 to 4896 and is all-in
MAYOUSSS folds
Tout4Maurice calls 4296
*** FLOP *** [8h Ts 3s]
*** TURN *** [8h Ts 3s][6h]
*** RIVER *** [8h Ts 3s 6h][9d]
*** SHOW DOWN ***
Tout4Maurice shows [Jh Ac] (High card : Ace)
AAccademiKK shows [Js As] (High card : Ace)
AAccademiKK collected 5246 from pot
Tout4Maurice collected 5246 from pot
*** SUMMARY ***
Total pot 10492 | No rake
Board: [8h Ts 3s 6h 9d]
Seat 2: Tout4Maurice (big blind) showed [Jh Ac] and won 5246 with High card : Ace
Seat 6: AAccademiKK (button) showed [Js As] and won 5246 with High card : Ace


Winamax Poker - Tournament "Qualif. Ticket 10€" buyIn: 1.80€ + 0.20€ level: 14 - HandId: #853654187785846785-121-1497875697 - Holdem no limit (80/300/600) - 2017/06/19 12:34:57 UTC
Table: 'Qualif. Ticket 10€(198756854)#000' 6-max (real money) Seat #1 is the button
Seat 1: MAYOUSSS (7508)
Seat 2: Tout4Maurice (9826)
Seat 4: manggy94 (10630)
Seat 5: -jaiminho- (23018)
Seat 6: AAccademiKK (5246)
*** ANTE/BLINDS ***
Tout4Maurice posts ante 80
manggy94 posts ante 80
MAYOUSSS posts ante 80
-jaiminho- posts ante 80
AAccademiKK posts ante 80
Tout4Maurice posts small blind 300
manggy94 posts big blind 600
Dealt to manggy94 [7d 8d]
*** PRE-FLOP *** 
-jaiminho- folds
AAccademiKK folds
MAYOUSSS folds
Tout4Maurice calls 300
manggy94 checks
*** FLOP *** [8h 6s Jc]
Tout4Maurice bets 600
manggy94 calls 600
*** TURN *** [8h 6s Jc][8s]
Tout4Maurice checks
manggy94 checks
*** RIVER *** [8h 6s Jc 8s][Ad]
Tout4Maurice checks
manggy94 bets 1400
Tout4Maurice folds
manggy94 collected 4200 from pot
*** SUMMARY ***
Total pot 4200 | No rake
Board: [8h 6s Jc 8s Ad]
Seat 4: manggy94 (big blind) won 4200


Winamax Poker - Tournament "Qualif. Ticket 10€" buyIn: 1.80€ + 0.20€ level: 14 - HandId: #853654187785846785-122-1497875720 - Holdem no limit (80/300/600) - 2017/06/19 12:35:20 UTC
Table: 'Qualif. Ticket 10€(198756854)#000' 6-max (real money) Seat #2 is the button
Seat 1: MAYOUSSS (7428)
Seat 2: Tout4Maurice (8546)
Seat 4: manggy94 (12150)
Seat 5: -jaiminho- (22938)
Seat 6: AAccademiKK (5166)
*** ANTE/BLINDS ***
manggy94 posts ante 80
-jaiminho- posts ante 80
MAYOUSSS posts ante 80
Tout4Maurice posts ante 80
AAccademiKK posts ante 80
manggy94 posts small blind 300
-jaiminho- posts big blind 600
Dealt to manggy94 [Qc 5s]
*** PRE-FLOP *** 
AAccademiKK folds
MAYOUSSS folds
Tout4Maurice folds
manggy94 folds
-jaiminho- collected 1300 from pot
*** SUMMARY ***
Total pot 1300 | No rake
Seat 5: -jaiminho- (big blind) won 1300


Winamax Poker - Tournament "Qualif. Ticket 10€" buyIn: 1.80€ + 0.20€ level: 14 - HandId: #853654187785846785-123-1497875747 - Holdem no limit (80/300/600) - 2017/06/19 12:35:47 UTC
Table: 'Qualif. Ticket 10€(198756854)#000' 6-max (real money) Seat #4 is the button
Seat 1: MAYOUSSS (7348)
Seat 2: Tout4Maurice (8466)
Seat 4: manggy94 (11770)
Seat 5: -jaiminho- (23558)
Seat 6: AAccademiKK (5086)
*** ANTE/BLINDS ***
-jaiminho- posts ante 80
AAccademiKK posts ante 80
MAYOUSSS posts ante 80
Tout4Maurice posts ante 80
manggy94 posts ante 80
-jaiminho- posts small blind 300
AAccademiKK posts big blind 600
Dealt to manggy94 [5s 3h]
*** PRE-FLOP *** 
MAYOUSSS folds
Tout4Maurice folds
manggy94 folds
-jaiminho- calls 300
AAccademiKK checks
*** FLOP *** [Qh Kc 4c]
-jaiminho- checks
AAccademiKK checks
*** TURN *** [Qh Kc 4c][7d]
-jaiminho- checks
AAccademiKK checks
*** RIVER *** [Qh Kc 4c 7d][Qd]
-jaiminho- checks
AAccademiKK bets 1200
-jaiminho- folds
AAccademiKK collected 2800 from pot
*** SUMMARY ***
Total pot 2800 | No rake
Board: [Qh Kc 4c 7d Qd]
Seat 6: AAccademiKK (big blind) won 2800


Winamax Poker - Tournament "Qualif. Ticket 10€" buyIn: 1.80€ + 0.20€ level: 14 - HandId: #853654187785846785-124-1497875804 - Holdem no limit (80/300/600) - 2017/06/19 12:36:44 UTC
Table: 'Qualif. Ticket 10€(198756854)#000' 6-max (real money) Seat #5 is the button
Seat 1: MAYOUSSS (7268)
Seat 2: Tout4Maurice (8386)
Seat 4: manggy94 (11690)
Seat 5: -jaiminho- (22878)
Seat 6: AAccademiKK (6006)
*** ANTE/BLINDS ***
AAccademiKK posts ante 80
MAYOUSSS posts ante 80
Tout4Maurice posts ante 80
manggy94 posts ante 80
-jaiminho- posts ante 80
AAccademiKK posts small blind 300
MAYOUSSS posts big blind 600
Dealt to manggy94 [5d Ad]
*** PRE-FLOP *** 
Tout4Maurice raises 7706 to 8306 and is all-in
manggy94 folds
-jaiminho- folds
AAccademiKK folds
MAYOUSSS folds
Tout4Maurice collected 9606 from pot
*** SUMMARY ***
Total pot 9606 | No rake
Seat 2: Tout4Maurice won 9606


Winamax Poker - Tournament "Qualif. Ticket 10€" buyIn: 1.80€ + 0.20€ level: 14 - HandId: #853654187785846785-125-1497875828 - Holdem no limit (80/300/600) - 2017/06/19 12:37:08 UTC
Table: 'Qualif. Ticket 10€(198756854)#000' 6-max (real money) Seat #6 is the button
Seat 1: MAYOUSSS (6588)
Seat 2: Tout4Maurice (9606)
Seat 4: manggy94 (11610)
Seat 5: -jaiminho- (22798)
Seat 6: AAccademiKK (5626)
*** ANTE/BLINDS ***
MAYOUSSS posts ante 80
Tout4Maurice posts ante 80
manggy94 posts ante 80
-jaiminho- posts ante 80
AAccademiKK posts ante 80
MAYOUSSS posts small blind 300
Tout4Maurice posts big blind 600
Dealt to manggy94 [7h 6s]
*** PRE-FLOP *** 
manggy94 folds
-jaiminho- folds
AAccademiKK raises 4946 to 5546 and is all-in
MAYOUSSS folds
Tout4Maurice folds
AAccademiKK collected 6846 from pot
*** SUMMARY ***
Total pot 6846 | No rake
Seat 6: AAccademiKK (button) won 6846


Winamax Poker - Tournament "Qualif. Ticket 10€" buyIn: 1.80€ + 0.20€ level: 14 - HandId: #853654187785846785-126-1497875841 - Holdem no limit (80/300/600) - 2017/06/19 12:37:21 UTC
Table: 'Qualif. Ticket 10€(198756854)#000' 6-max (real money) Seat #1 is the button
Seat 1: MAYOUSSS (6208)
Seat 2: Tout4Maurice (8926)
Seat 4: manggy94 (11530)
Seat 5: -jaiminho- (22718)
Seat 6: AAccademiKK (6846)
*** ANTE/BLINDS ***
Tout4Maurice posts ante 80
manggy94 posts ante 80
MAYOUSSS posts ante 80
-jaiminho- posts ante 80
AAccademiKK posts ante 80
Tout4Maurice posts small blind 300
manggy94 posts big blind 600
Dealt to manggy94 [3s 2c]
*** PRE-FLOP *** 
-jaiminho- folds
AAccademiKK raises 6166 to 6766 and is all-in
MAYOUSSS folds
Tout4Maurice folds
manggy94 folds
AAccademiKK collected 8066 from pot
*** SUMMARY ***
Total pot 8066 | No rake
Seat 6: AAccademiKK won 8066


Winamax Poker - Tournament "Qualif. Ticket 10€" buyIn: 1.80€ + 0.20€ level: 14 - HandId: #853654187785846785-127-1497875868 - Holdem no limit (80/300/600) - 2017/06/19 12:37:48 UTC
Table: 'Qualif. Ticket 10€(198756854)#000' 6-max (real money) Seat #2 is the button
Seat 1: MAYOUSSS (6128)
Seat 2: Tout4Maurice (8546)
Seat 4: manggy94 (10850)
Seat 5: -jaiminho- (22638)
Seat 6: AAccademiKK (8066)
*** ANTE/BLINDS ***
manggy94 posts ante 80
-jaiminho- posts ante 80
MAYOUSSS posts ante 80
Tout4Maurice posts ante 80
AAccademiKK posts ante 80
manggy94 posts small blind 300
-jaiminho- posts big blind 600
Dealt to manggy94 [Jc 5s]
*** PRE-FLOP *** 
AAccademiKK folds
MAYOUSSS folds
Tout4Maurice folds
manggy94 folds
-jaiminho- collected 1300 from pot
*** SUMMARY ***
Total pot 1300 | No rake
Seat 5: -jaiminho- (big blind) won 1300


Winamax Poker - Tournament "Qualif. Ticket 10€" buyIn: 1.80€ + 0.20€ level: 14 - HandId: #853654187785846785-128-1497875883 - Holdem no limit (80/300/600) - 2017/06/19 12:38:03 UTC
Table: 'Qualif. Ticket 10€(198756854)#000' 6-max (real money) Seat #4 is the button
Seat 1: MAYOUSSS (6048)
Seat 2: Tout4Maurice (8466)
Seat 4: manggy94 (10470)
Seat 5: -jaiminho- (23258)
Seat 6: AAccademiKK (7986)
*** ANTE/BLINDS ***
-jaiminho- posts ante 80
AAccademiKK posts ante 80
MAYOUSSS posts ante 80
Tout4Maurice posts ante 80
manggy94 posts ante 80
-jaiminho- posts small blind 300
AAccademiKK posts big blind 600
Dealt to manggy94 [3h 6h]
*** PRE-FLOP *** 
MAYOUSSS folds
Tout4Maurice folds
manggy94 folds
-jaiminho- raises 600 to 1200
AAccademiKK folds
-jaiminho- collected 2200 from pot
*** SUMMARY ***
Total pot 2200 | No rake
Seat 5: -jaiminho- (small blind) won 2200


Winamax Poker - Tournament "Qualif. Ticket 10€" buyIn: 1.80€ + 0.20€ level: 14 - HandId: #853654187785846785-129-1497875912 - Holdem no limit (80/300/600) - 2017/06/19 12:38:32 UTC
Table: 'Qualif. Ticket 10€(198756854)#000' 6-max (real money) Seat #5 is the button
Seat 1: MAYOUSSS (5968)
Seat 4: manggy94 (10390)
Seat 5: -jaiminho- (24178)
Seat 6: AAccademiKK (7306)
*** ANTE/BLINDS ***
AAccademiKK posts ante 80
MAYOUSSS posts ante 80
manggy94 posts ante 80
-jaiminho- posts ante 80
AAccademiKK posts small blind 300
MAYOUSSS posts big blind 600
Dealt to manggy94 [6c As]
*** PRE-FLOP *** 
manggy94 raises 600 to 1200
-jaiminho- folds
AAccademiKK folds
MAYOUSSS folds
manggy94 collected 2420 from pot
*** SUMMARY ***
Total pot 2420 | No rake
Seat 4: manggy94 won 2420


Winamax Poker - Tournament "Qualif. Ticket 10€" buyIn: 1.80€ + 0.20€ level: 15 - HandId: #853654187785846785-130-1497875956 - Holdem no limit (100/400/800) - 2017/06/19 12:39:16 UTC
Table: 'Qualif. Ticket 10€(198756854)#000' 6-max (real money) Seat #6 is the button
Seat 1: MAYOUSSS (5288)
Seat 4: manggy94 (11530)
Seat 5: -jaiminho- (24098)
Seat 6: AAccademiKK (6926)
*** ANTE/BLINDS ***
MAYOUSSS posts ante 100
manggy94 posts ante 100
-jaiminho- posts ante 100
AAccademiKK posts ante 100
MAYOUSSS posts small blind 400
manggy94 posts big blind 800
Dealt to manggy94 [Ac 8h]
*** PRE-FLOP *** 
-jaiminho- folds
AAccademiKK raises 6026 to 6826 and is all-in
MAYOUSSS folds
manggy94 calls 6026
*** FLOP *** [Kc 7d 8s]
*** TURN *** [Kc 7d 8s][2h]
*** RIVER *** [Kc 7d 8s 2h][As]
*** SHOW DOWN ***
manggy94 shows [Ac 8h] (Two pairs : Aces and 8)
AAccademiKK shows [2d 2s] (Trips of 2)
AAccademiKK collected 14452 from pot
*** SUMMARY ***
Total pot 14452 | No rake
Board: [Kc 7d 8s 2h As]
Seat 4: manggy94 (big blind) showed [Ac 8h] and lost with Two pairs : Aces and 8
Seat 6: AAccademiKK (button) showed [2d 2s] and won 14452 with Trips of 2


Winamax Poker - Tournament "Qualif. Ticket 10€" buyIn: 1.80€ + 0.20€ level: 15 - HandId: #853654187785846785-131-1497875989 - Holdem no limit (100/400/800) - 2017/06/19 12:39:49 UTC
Table: 'Qualif. Ticket 10€(198756854)#000' 6-max (real money) Seat #1 is the button
Seat 1: MAYOUSSS (4788)
Seat 4: manggy94 (4604)
Seat 5: -jaiminho- (23998)
Seat 6: AAccademiKK (14452)
*** ANTE/BLINDS ***
manggy94 posts ante 100
-jaiminho- posts ante 100
MAYOUSSS posts ante 100
AAccademiKK posts ante 100
manggy94 posts small blind 400
-jaiminho- posts big blind 800
Dealt to manggy94 [Qd 3s]
*** PRE-FLOP *** 
AAccademiKK folds
MAYOUSSS folds
manggy94 folds
-jaiminho- collected 1600 from pot
*** SUMMARY ***
Total pot 1600 | No rake
Seat 5: -jaiminho- (big blind) won 1600


Winamax Poker - Tournament "Qualif. Ticket 10€" buyIn: 1.80€ + 0.20€ level: 15 - HandId: #853654187785846785-132-1497876006 - Holdem no limit (100/400/800) - 2017/06/19 12:40:06 UTC
Table: 'Qualif. Ticket 10€(198756854)#000' 6-max (real money) Seat #4 is the button
Seat 1: MAYOUSSS (4688)
Seat 4: manggy94 (4104)
Seat 5: -jaiminho- (24698)
Seat 6: AAccademiKK (14352)
*** ANTE/BLINDS ***
-jaiminho- posts ante 100
AAccademiKK posts ante 100
MAYOUSSS posts ante 100
manggy94 posts ante 100
-jaiminho- posts small blind 400
AAccademiKK posts big blind 800
Dealt to manggy94 [Kd 3s]
*** PRE-FLOP *** 
MAYOUSSS folds
manggy94 folds
-jaiminho- raises 800 to 1600
AAccademiKK folds
-jaiminho- shows [Td Ah] (High card : Ace)
-jaiminho- collected 2800 from pot
*** SUMMARY ***
Total pot 2800 | No rake
Seat 5: -jaiminho- (small blind) showed [Td Ah] and won 2800 with High card : Ace


Winamax Poker - Tournament "Qualif. Ticket 10€" buyIn: 1.80€ + 0.20€ level: 15 - HandId: #853654187785846785-133-1497876035 - Holdem no limit (100/400/800) - 2017/06/19 12:40:35 UTC
Table: 'Qualif. Ticket 10€(198756854)#000' 6-max (real money) Seat #5 is the button
Seat 1: MAYOUSSS (4588)
Seat 4: manggy94 (4004)
Seat 5: -jaiminho- (25798)
Seat 6: AAccademiKK (13452)
*** ANTE/BLINDS ***
AAccademiKK posts ante 100
MAYOUSSS posts ante 100
manggy94 posts ante 100
-jaiminho- posts ante 100
AAccademiKK posts small blind 400
MAYOUSSS posts big blind 800
Dealt to manggy94 [5d Qs]
*** PRE-FLOP *** 
manggy94 folds
-jaiminho- folds
AAccademiKK raises 800 to 1600
MAYOUSSS folds
AAccademiKK collected 2800 from pot
*** SUMMARY ***
Total pot 2800 | No rake
Seat 6: AAccademiKK (small blind) won 2800


Winamax Poker - Tournament "Qualif. Ticket 10€" buyIn: 1.80€ + 0.20€ level: 15 - HandId: #853654187785846785-134-1497876071 - Holdem no limit (100/400/800) - 2017/06/19 12:41:11 UTC
Table: 'Qualif. Ticket 10€(198756854)#000' 6-max (real money) Seat #6 is the button
Seat 1: MAYOUSSS (3688)
Seat 4: manggy94 (3904)
Seat 5: -jaiminho- (25698)
Seat 6: AAccademiKK (14552)
*** ANTE/BLINDS ***
MAYOUSSS posts ante 100
manggy94 posts ante 100
-jaiminho- posts ante 100
AAccademiKK posts ante 100
MAYOUSSS posts small blind 400
manggy94 posts big blind 800
Dealt to manggy94 [Qh 3c]
*** PRE-FLOP *** 
-jaiminho- folds
AAccademiKK raises 800 to 1600
MAYOUSSS folds
manggy94 folds
AAccademiKK collected 3200 from pot
*** SUMMARY ***
Total pot 3200 | No rake
Seat 6: AAccademiKK (button) won 3200


Winamax Poker - Tournament "Qualif. Ticket 10€" buyIn: 1.80€ + 0.20€ level: 15 - HandId: #853654187785846785-135-1497876091 - Holdem no limit (100/400/800) - 2017/06/19 12:41:31 UTC
Table: 'Qualif. Ticket 10€(198756854)#000' 6-max (real money) Seat #1 is the button
Seat 1: MAYOUSSS (3188)
Seat 4: manggy94 (3004)
Seat 5: -jaiminho- (25598)
Seat 6: AAccademiKK (16052)
*** ANTE/BLINDS ***
manggy94 posts ante 100
-jaiminho- posts ante 100
MAYOUSSS posts ante 100
AAccademiKK posts ante 100
manggy94 posts small blind 400
-jaiminho- posts big blind 800
Dealt to manggy94 [Qh Jd]
*** PRE-FLOP *** 
AAccademiKK folds
MAYOUSSS raises 2288 to 3088 and is all-in
manggy94 calls 2504 and is all-in
-jaiminho- folds
*** FLOP *** [Kh 4h Qc]
*** TURN *** [Kh 4h Qc][As]
*** RIVER *** [Kh 4h Qc As][8d]
*** SHOW DOWN ***
manggy94 shows [Qh Jd] (One pair : Queens)
MAYOUSSS shows [Ts Ah] (One pair : Aces)
MAYOUSSS collected 7192 from pot
*** SUMMARY ***
Total pot 7192 | No rake
Board: [Kh 4h Qc As 8d]
Seat 1: MAYOUSSS (button) showed [Ts Ah] and won 7192 with One pair : Aces
Seat 4: manggy94 (small blind) showed [Qh Jd] and lost with One pair : Queens


